--------------------------------------------------------------------------------------------------------------------------------------------------------------------?-----------------------------------
-----------------------------------------------------------------------B--------------------------------------------------------------------------------------------------------------------------------
--------------------------------------------------------------------------------------------------------------------------------------------------------------------------------------------------------
-----------------------------------------------------------X-----o--------------------------------------------------------------------------------------------------------------------------------------
------------------------------------------------------------B?------------------------------------------------------------------------------------------------------------------------------------------
-------------------------------------------------o--------------o----------------M-----------------------------------------------------------------------------------X----------------------------------
-------------------------------------------------------X-----------------------------------------------------------------------------------o------------------------XX-----?----------------------------
------------------------------------------------------XX-----------------------------------------------------------------------------------------------------------XXX----------------------------o----v
-----------------------------------------------------XXX----------------------------------------------------------------------------------------------------------XXXX---------------------------------f
-------------M--------------------------------------XXXX-----------------------------------------------------------------------o---------------------------------XXXXX---------------------------------f
---------------------------------------------------XXXXX---------------X----------------------------------------------------------------------------------------XXXXXX---------------------------------f
-----------------------------------------B--------XXXXXX-------------------------------------------------------------------------------------------------------XXXXXXX--------------------------------Tf
---------------?---------------------------------XXXTXXX-----------------------------------------------------------------------------------M------------------XXXXXXXX--------------------------------|f
--------------------------------------------B---XXXX|XXX-----B----T------------------------------------------------------------------------------------------XXXXXXXXX---------------------T----------|f
m----------------------------------------------XXXXX|XXX----------|----------------------------------------------------E------------------------------------XXXXXXXXXX-----------------X---|----------|X
XXXXX--------XXXXXXXXXXXXXXXXXXXXXXXXXXXXXXXXXXXXXXX|XXXXXX-------|XXXXXXXXXXXXXXXXXXXXXXXXXXXXXXXXXXXXXXXXX----XXXXXXXXXXXXXXXXXXXXXXXXXXXXXXXXX-------XXXXXXXXXXXXXX-XXXXXXXXXXXXXXXXXXXX|XX----XXXX|X
