--------------------------------------------------o------o----o--------o----------------o-----------------------------------------------------------------------------------o---------------------------
-------------------------o-----------------------------------------------------------------o-------------------------------ooo-------------------------o----o-------------------------o-----------------
----------------------------------------------------------------------------------------------------------------------------o--------------o------------o---------------------------------------------o-
----------------------------------------------------------------------------------------------------------------o------------T------o---------------------------------------o---o-------------------o---
----------T---------------------------------------------|------------------------------M-----------------E------------------------------o---------------------o-B------------o--------------------------
--------------------------?-------------------------E-----------------------------------------------------------------------o-----------|------------o-----------------------------|--------------------
-----B------------------------B----o------------o---------------|-----B-------------X---------------|-------------------------------E---------T---------------------------------------------------------
------------------------------------------------------M-------------------|--?---------o---------------------------------------------------o-------------------------------B---------------------------v
---------o-----------------------------------------o----------o------------------------o-----o-------------X-----------|----------------------------------------------------------X--------------------f
-------------------------------------------o--|------------|----------------------------------------------------------------------------------------------------------E----o--------------------------of
---?--M-MBX----------M?-------|B------------X---?X-M-------?--M----?-------Xo--?-M?---M-B--ME------B--B----X------------?----??B-----X--B--Boo-M--X-BB------??B-?--?X---------------M-----B-X-?--M---X-f
------------?-----------------?-------B-----X-XB-B----XM?X-?--M---o-?---------?M--?------X-------------Bo------M----------X------M------??--o-------------X-----o----------o-----M--M---B-B--o---------f
--T-T--B?B-MT|-----B--T-T--TMX--B----TTT?-X--TT-------o--B-TT-?-----T-?TB--oB---XMT-BM-?-BX-----T-T--M--B------?----?oT?-?-TT----B--M--MT-T--T-------T-?XTT---?T-T-B-----B-TXTX---M---TT-------T--o--TXf
--TXB--X-|--|----T---X|-|M-|T--T--TXM|M|-----X|TT|---T-T-?-||?T-----|--|-BX---X---X-oT--T-T-BM--|-TMTBX--XM---??-X--BT-----||T--------T-TT|-?|--M----|--TBTM-B-|T|---?----T|||T-E-MT--|BT----TB|----B|-f
m-M-EE-TM|-?XTX--|---?|E|-T|E--|EET-EEE|-oET?|-?|--TE|ETE-M||E|T--T-T?-|--|E-ETT--|-T|--|-|B----|B|E|--E-E------EB-E---EX--|M|---BEE-B|-|EE-E|XEB-T--|B-T||EX--T||-X--EET-?|E||--EM|B-|||-?X-TM|EETE---X
XX|X|XX|X|X|||XXX|XXXX|X|X|||XX||||XX|||XXX|X||||XX|X|X|XXX||X||XX|X|XX|XX||X|||XX|X||XX|X|XXXXX|X|X|XXXXXXXXXXX|XXXX|XXXXX|||XXXXXXXX|X|||XX|XXXX|XX||X||||XXX|||XXXXXX|X|||||XXXX|XX|||XXXX|X|X||XX|XX
