---------------------------------------------------------------------------------------------------X---------------------------------------------------------------o------------------------------o-----
---------------------------------------------------------------------------------------------------------------------------------------------------X----------------------------------------------------
-------------------------------o------------------------------------------------------------------------------------------------o-----------------------------------------------------------------------
----------------------------------------------------------------------------------------------------------------------------------------------------------------oo--------------------------------------
----------------------------------------------------------------------------------------------------------------------------X----?----------------------------------------------------------------------
---------------------------------------------------------------------------------------------------------------------------XX---------------------------------------------------------------------------
-------------------------------------------------X------------------------X---------------------------o-----------------M-XXX---------------------------------------------------------------------------
------------------------------------------------XX-----------------------XX----------------------------------------------XXXX--------------------------------------------------------------------------v
-----------------------------------------------XXX----------------------XXX------------------------------?--------------XXXXX-------------------------------------X------------------------------------f
------o---------------------------------------XXXX---------------------XXXX--------------------------------------------XXXXXX--------------------------------------------------------------------------f
---------------------------------------------XXXXX--------------------XXXXX----------------------------------B--------XXXXXXX---------------------BBBBBBBB---------------------------------------------f
---------------B----------------------------XXXXXX--------?----------XXXXXX-----------------------------B------------XXXXXXXX--------------------------------T-----------X-----------------------------f
-------------------------------------------XXXXXXX---------------T--XXXXXXX-----------------------T--X--------------XXXXXXXXX---------o--------------T--X----|----------XX-----------------------------f
------------------------------------------XXXXXXXX---------------|-XXXXXXXX-----------------------|-XX-------------XXXXXXXXXX-----X------------------|-------|---------XXX-----------------------------f
m--------B-------------------------------XXXXXXXXX---------------|XXXXXXXXX----------E------------|XXX------------XXXXXXXXXXX-----------E----E-------|----E--|--------XXXX----------------E------------X
XXXXXXXXXXXXXXXXXXXXXXXXXXXXXXXXXXXXXXXXXXXXXXXXXXXXXXXXX---XXXXX|XXXXXXXXXXXXXXXXXXXXXXXXXXXXXXXX|XXXXXXXXXX-XXXXXXXXXXXXXXX---XXXXXXXXXXXXXX-----XX|XXXXXXX|XXXXXXXXXXXXXXXXXXXXXXXXXXXXXXXXXXXXXXXXXX
