--------------------------------------------------------------------------------------------------M--------------------------------------------------------------------------------o--------------------
----------------------------?---------------------------------------------------------------------------------------------------------------------------------------------------------------------------
--------------------------------------------------------------------------------------------------------------------------------------------------------------------------------------------------------
-------------------------------------------------------------????---------------------------------------------------------------------------------------------------------------------------------------
--------------------------------o---------------------------------------------------o---X---------------------------------------------------------------------------------------------------------------
--------------------------------------------------------------------------------------------------------------------------------------------------------------------------------------------------------
----------------------------------------------------------XXX--------------------------------------------------------------------------------------------------------------?----------------------------
-----------------------------------------------X--------------------------------------------------------------------------------------------------------------------------------------------------o----v
-------------------------------------------------------------------------------------------------------------------------------------------------------------------------------------------------------f
--------------------------------------------------------------------------------------B------------------------------------------------------------------------------------???????---------------------f
-----------------------------------------------------------------------------o-------------------------------------------------------------------------------------------------------------------------f
------------------------------------------------------------------------------------------------------------------------------------------------------------------------------------------------------Tf
----XXXXXXXX---------------------------------------------------------------------------------------------------X-----------------------------------------------------------T--------------------------|f
----------------------------------------------------------------------o----------------------------------------XX----------------------------------------------------------|---------------T----------|f
mX---E------------------------E----------------------------------------------------------------------E---------XXX------------------------------------------------------E--|-----------X---|----------|X
XXXXXXXXXXXX--XXXXXXXXXXXX?XXXXXXXXXXXXXXXXXXXXXXXXXXXXXXXXXXXXXXXXXXXXXXX------XXXXXXXXXXXXXXXXXXXXXXXXXXXXXXXXXXXXXXXXXXXXXXX--------XXXXXXXXXXXXXXXXXXXXXXXXXXXXXXXXXXXX|XXXXXXXXXXXXXXX|XX----XXXX|X
