--------------------------------------------------------------------------------------------------------------------------------------------------------------------------------------------------------
--o--------------------------------------------------------------------B--------------------------------------------------------------------------------------------------------------------------------
--------------------------------------------------------------------------------------------------------------------------------------------------------------------------------------------------------
--------------------------------------------------------------------------------------------------------------------------------------------------------------------------------------------------------
------------------------------------------------------------B-------------------------------------------------------------------------------------------------------------------------------------------
-------------------------------------------------o-------------------------------------------------------------------------------------------------------------------X----------------------------------
------------X-------------------------------------------------------------------------------------------------------------------------------------------------------XX-----?----------------------------
-----------XX------------------------------------------------------------------------------------------------------------------------------------------------------XXX---------------------------------v
----------XXX-----------------------------------------------------------------------------------------------------------------------------------------------------XXXX---------------------------------f
---X-----XXXXM---------------------------------------------------------------------------------------------------------------------------------------------------XXXXX---------------------------------f
--------XXXXX-----------------------o---------------------------------------------------------------------------------------------------------------------------XXXXXX---------------------------------f
-------XXXXXX----------------------------B---------------------------------------------------------------------------------------------------------------------XXXXXXX--------------------------------Tf
------XXXXXXX--?----------------------------------------------------------------------------------------------------------------------------------------------XXXXXXXX--------------------------------|f
-----XXXXXXXX------------------------------------------------------------------------------------------------------------------------------------------------XXXXXXXXX---------------------T----------|f
m-M-XXXXXXXXX-----------------------------------E-----------------------------------------------------------------------------------------------------------XXXXXXXXXX---------------------|----------|X
XXXXXXXXXXXXXXXXXXXXXXXXXXX---XXXXXXXXXXXXXXXXXXXXXXXXXXXXXXXXXXXXXXXXXXXXXXXXXXXXXXXXXXXXXXXXXXXXXXXXXXXXXXXXXXXXXXXXXXXXXXXXXXXXXXXXXXXXXXXXXXXXXXXXXXXXXXXXXXXXXXXXXXXXXXXXXXXXXXXXXXXXX|XX----XXXX|X
