---------------------------------XX---------------------------------------------------------------------------------------------------------------------------------------------------------------------
--------------------------------------------------------------------------------------------------------------------------------------------------------------------------------------------------------
--o--------------------------------------------------------------------------------------------------------------------------------M--------------------------------------------------------------------
--------------------------------?-------------------------------------------------------------------------------X---------------------------------------------------------------------------------------
----------------------------B---------------------------------------------------------------------------------------------------------------------------------------------------------------------------
---------------------------------------------------------------------X-o---------------------------------------------------?------------------------------------------------XXXXX-----------------------
--B------------------------X----------------------------------------XX-------------------------------------------------------------------------------------------------X-------XX-----------------------
-------------------------------------------------------------------XXX----------------------------------------------------------------------------B----------------------------------------------------v
------------------------------------------------------------------XXXX--------------------------------------------X------------------------------------------------------------------------------------f
------------------------------------X----------------------------XXXXX-------------------------------------------XX--------------------------------------------X---------------------------------------f
-----T----------------------------------------------------------XXXXXX------------------------------------------XXX-BBB---------BBBBBB------------------------XX---------------------------------------f
-----|---------------------------------------------------------XXXXXXX-----------------------------------------XXXX------------------------------------------TXX--????????-----------------------------f
-----|----------???????--------------------o------------------XXXXXXXX------------------X---------------------XXXXX-----------------------------------------X|XX---------------------------------------f
-----|----------------------------------??????---------------XXXXXXXXX---------------------------------------XXXXXX----------------------------T-----------XX|XX---------------------------------------f
m----|--------o--E-------------------E------E----BBB---E----XXXXXXXXXX-----------------------------E--------XXXXXXX-E-------------------E------|-E---?----XXX|XXE-----------------o--------------------X
XXXXX|-----XXXXXXXXX--XXXXXXXXXXXXXXXXX----?------XX-XXXXXXXXXXXXXXXXXX---XXXXXXXXXXXXXXXXXXXXXXXXXXXXXXXXXXXXXXXXXXXXXXXXX---XXXXXXXXXXXXXXXXX|XXXXXXXXXXXXX|XXXXXXXXXXXXXXXXXXXXXXXXXXXX--------XXXXXX
