---------o------------o-------------------------------------------------------------------------------------------------------------------o---o-------o----o------------o-------------------------o-----
--------------------------------------------------o--------o---------------------------------o-----------------------------------------------------------------------------------o--------o-------------
---------------------|------o-----o--o---o------------o--------o-X--------------o-----------------------------------------------o---o---------------------------o--------o------------------------------
------------------------o---------------------------------o-o----------------------o------------------------------o------T------------------------------------------------------------------------------
------------------------------------------M-o--o--------|----o-X----------------------------------------------------------o----o-o-------------------------o-----------------------o-------------o------
------o-------------------------M-----|----o------------------------oB--o----B-----o--|------X-------------T-----------------------?-----------------------------o---------o---o------------------------
-------o-o------?--------------------------------o---------------------------o------------------------|--------------------------o----o--------------------------------------|----------o---------------
-----------------o----------------------------------------X-----------------------o--------------o------o----X----B---------------?-----------------------------------------------o-----|--------------v
-------o---------------oo--------|----oo--------T--------------------X---o--X--------------------------------------------------------------------------------?---o--o--?-----------B-------------------f
-----B-----------------o----------------o--o------------------o----o------------------------------------------------------|--o---------B-------------------------------------------------o--o-X-----o--f
--B--B---X?-B----Mo--M--X-oBMMM-X--B--o---B---XM?-M---X?---X---XMX-X-B-B--B---B?---M--?M--M-?M-o---o-??----oB?XXXM-M-?-?-B-MB?---B--XX-B?--?--??X-M?B-?o--B--XM--?-M--M-M----B-M-X-?-??M---o-M---B--?-Bf
-------MM------?M-?M--?BBB?oM-?-BM----XX?-B?-M--Xo-----M--?--------X??MBX-X--?oMB-X-?B-X-o-?MX-X--X-M-MM--?X--M?-M----ooX----?M---o---???-|-B--MB?-M-XBX-B----X--o-?B--M-o--B-o-?---MMB--MXM-?M---?---Bf
--MMMTMBTXT-?X--BM?----T?-MT-X---?XTToXo--M-TXX-?---TB--TTX-----B--T----o-X?-XTT----T-MXo-TMT-MT--X?T?T-T--TMTTM---X-M----?TTTT--TT?XT?TT-M-?M-----B-T-MBT-XTXT-M-BT-BBT--B--TBM-TM-----MTo--?T----X-T-f
-T||-|--|T|-BBTTB-To-M-|M-|T-TTB-T|T|---BBo?|MM--XTT?TTXB|MTo?T?|B?|?TTBT-BT-T||--T-B?|TX-|?|-T|-T-T|MX-B-?-B|||------?MMTT||||-T|T--XTMTM?-MMTMB---T|?-M|??|-TT??-|TT-X-?oX-|-?-MTBT-M-MT?-TT|oX?-TT|of
mET|-ME-|EEXEE||TME---BT|-TTE||-TE|||?---TEX|?-ETMX||?|M||-|TTE?BB||T||T??EET|||EBXT|TE|??|T|T|BET-|M|EBE-B|TEEET-EMETE--TEEB||E||MTM||?|ETEEE||EXXEE|-EM|-B|XT|?EXE||EEBETME|E-EMEE|T-TEE|XTE|-XEX|o|-X
X|||X||X|||XXX|||X|XXXX||X||X||X||||||XXX|XX|XXX|X||||||||X||||||X|||||||XX|||||XX||||||XX||||||||X||||X|X|||||||XXXX|XXX||||||X||||X||||||X|||||XX|||XX||XX||||XXX|||||XX|XX|X|X||X||X||||||||XX|||||XX
