----------------------o------o-----------------------------------------------------------------------------------------------------------------o--o-------------------------------------------o---o-----
----------------------------------o-----------o-----------o-------------------------------------------------------------o-----------------------------------------------------------------------------o-
--------------------------------|--------------------------------------T---------------------------------o-------------------------B----------------o------------------------------------o-M------o-----
-------------X-------o----------------------o---------------o---E-----------------------o----------X------------o--------------------------------------------------------------------o-oo---------------
----------------------------------------o----------------------------------------o---------------?------B--------------------------------o---------------------|----------------------------------------
----------o---------o------------------E----------------X--------oo-----o---oB--------|-----------o-----------------------------------------------------o------o----o---T-------------------------------
-o--------------------------------------o---?-----T--------------------------o------------?----|-------------------------------B-----B-o-----X---------o--------------------------------------------oo--
---T-----------------------T--------------------------?----------------------------------o---------------o------------------------------T----------o------T------------------------o-------------------v
------------------------o----o----------------------------------------------X-----------o--o------------o-----------o------o-------------------oo-------------------------o--B--------------------o----f
--------o--------o------o----------------------------------o---------------------------------------------------o--------|---------o---o---------------------------o----o-----o-------------|-----------f
----??M-XB-------X----M--?MB?-XX------B--XB--X-----?-----M---?--E--------?-----?-BM--X--M-M--??-XM-X-?B-?-B?-B-?-M--B--X-?-?-M-B--XB-B---------M-X--M-?B--o-Xo-BX--??-----B---XB?--XM---?BXB--B----?--Bf
--XXXM-?--|---------X-?-X-XXX--M?--XX?M?---?M-X-XM--?-M-XX---M-M--o---BM--B?---X---?--B-M-?M-X?--M-MBM?XX-XX--M?-|MM-MB-M--B----X--??----B---B----?-X------?-X--------X-B--o-----?-XMM-MX--M---X----B-Xf
-M---T-XTBB?T-M-TT?M?B---BT-MTTX---??---?TX---X-MTTTMBTMM??oT?-?--M-T---o-M-T----To-?TBTT-X?MT--T-X--TT?-B-X-?T--MXXX---B--XB-TX--TX-T?oTTT-TT--o-oB--XT?-X?X--?-TT-XTMXM-BT------?T---TBX-o-B-T--XB-TTf
----?|--BMMT|-XX|??X|MXXM-BBM||--To?XT-TT||X?TBXT||||-T-MT-TM-BX--|-|---M?BMX-TT-|-T-|-|T-TT-?---TMT-||-TT?---X-M-XT-BTTX-TX|-||M-|T-|TTT||T||XT|T-TTXT|TT-|---M-|T-X|--|-T|-X----X|?-BXTX-?T|?TT--|T|Tf
mE?E-|ET|ET?|-E-EEEMTTETMToX-E?TMoTM||X|T||X-|EE|-X?|?|EMTE||BoX?TE||-oEE-|-|T|EM|E|B|EEX-EoM?E-||-EEE-E||M?E-T?TM-|XT|?To|-|B?TETT|ET|||||EETEET|E||EE|||E|ETTT-||-T|T?|E||T-ETTE||BBMEEETMME-||--|?|EX
X|XXX|X||||||XXX|||X||X|X||XX|||X||X||X||||X||XX|||||X|XX|X||XXXX||||XXXXX|X||||X|X|X|X||X||X|XX||X|X||X||XXXX|X|XX||||||X|X||||X|||X|||||||||X|||X||X||||X|||||X||X|||||X|||XX||X|||X|||X||||X||XX||||X
