-----------------------------------------------------------------------------------------------------------------------------------------M--------------------------------------------------------------
-------------------------------------------------------------------------------------------------------------------------------------------------------------B------------------------------------------
-------------------------------------------------------------------------------------XXXX---------------------------------------------------------------------------------------------------------------
--------------------------------------------------------------------------------------------------------------------------------------------------------------------------------------------------------
---------------------------------------------------------------------------------------------------------o------------------X---------------------------------------------------------------------------
--------------------------------------?------------------------------------------------------------------------------------XX---------------------------------------------------------------------------
-------------------------------------X---?--------------------------------X---------------------------o-------------------XXX-------------------------------------------------BBBBBB--------------------
------------------------------------XX---------------?-------------------XX-?-----XXXXX----------------------------------XXXX--------------------------------------------------------------------------v
-----------------------------------XXX----------------------------------XXX------------------------------?--------------XXXXX-------------------------------------X------------------------------------f
----------------------------------XXXX---------------XXXX--------------XXXX--------------------------------------------XXXXXX--------------------------------------------------------------------------f
---------------------------------XXXXX--------------------------------XXXXX----------------------------------B--------XXXXXXX------------------------------------B-----------------------------XX------f
--------------------------------XXXXXX-------------------------------XXXXXX------------------------------------------XXXXXXXX------??????---------X----------T----?------------------------------------f
-------------------------------XXXXXXX----------?-------------------XXXXXXX---------------------?-T-----------------XXXXXXXXXT-------BBBBBBBB----------------|-----------------------------------------f
------------------------------XXXXXXXXX-------------------T--------XXXXXXXX-----------------------|----------------XXXXXXXXXX|-------------------------------|T----------------------------------------f
m----------------------------XXXXXXXXX--------------------|-------XXXXXXXXX--E-------E------------|E-------E-E----XXXXXXXXXXX|------------------------------E||-------------E------E------E------------X
XXXXXXXXXXXXXXXXXXXXXXXX?XX-XXXXXXXXXXXXX--XXXXXXXXXXXXXXX|XXXXXXXXXXXXXXXXXXXXXXXXXXXXXXXXXXXXXXX|X-------X---XXXXXXXXXXXXXX|--XXXXXXXXXXXX----XXXXXXXXXXXXX||XXXXXXX-------XXXXXXXXXXXXXXXXXXXXXXXXX-X
