-------------------------------------------------------------------------------X-------------------X---------------------------------------------------------------o------------------------------------
------------------------------------------------------------X-------------------------------------------------------------------------------------------------------------------------------------------
--------------------------------------------------------------------------------------------------------------------------------o----------------------------------------------o------------------------
--------------------------------------------------------------------------------------------------------------------------------------------------------------------------------------o-----------------
--------------------------------------------------------------------------------------------------------------------------------------------------------------------------------------------------------
--------------------------------------------------------------------------------------------------------------------------------------------------------------------------------------------------------
-----------??------------------------------------X---------------------------B-------------X------------------------------------------------------------------------------------------------------------
------------------------????--------------------XX----------------------------------------XX------------------------------------------------------B----------------------------------------------------v
-----------------------------------------------XXX---------------------------------------XXX-------------?----------------------------------------------?---X------------------------------------------f
----------------------------------------------XXXX---------------B----------------------XXXX----------------------------------------XXXXXXXX---------------XX------------------------------------------f
---------------------------------------------XXXXX------------o------------------------XXXXX--------------------------------------------------------------XXX------------------------------------------f
--------------------------------------------XXXXXX--------?---------------------------XXXXXX------------B------------------------------------------------XXXX------------------------------------------f
-------------------------------------------XXXXXXX---------------T-------------------XXXXXXX------T----------------------------------BBBBBBBB-----------XXXXX------------------------------------------f
------------------------------------------XXXXXXXX---------------|------------------XXXXXXXX------|----------------------------------------------------XXXXXX------------------------------------------f
m-----E----------------------------------XXXXXXXXX---------------|-----------E-----XXXXXXXXX------|---------------------------------------------------XXXXXXXXX----EE---------------BBBBBBBB-----------X
XXXXXXXXXXXXXXXXXXXXXXXXXXXXXXXXXXXXXXXXXXXXXXXXXXXXXXXXX---XXXXX|XXXXXXXXXXXXXXXXXXXXXXXXXXXXXXXX|X-------XX-------XXXXXXXXX------XXXXXXXXXXXXXXXXXXXXXXXXXXXXXXXX--------XXXXXXXXXXXXXXXXXXXXXXX-----X
