--------------------------------------------------------------------------------------------------------------------------------------------------------------------------------------------------------
--------------------------------------------------------------------------------------------------------------------------------------------------------------------------------------------------------
------------------------------------------------------------------------------------------------------BBBBB------------------------M---------------------------X----------------------------------------
--------------------------------?-----------------------------------------------------------------------------------------------------------------------------------------------------------------------
--------------------------------------------------------------------------------------------------------------------------------------------------------------------------------------------------------
--------------------------------------?-----------------------------------------------------------------------------------------------------------------------------------------------------------------
--------------------------------------------------------------------------------------------------------------------------------------------------------------------------------------------------------
----------------------------------------------?---------------------------------------------------------------------------------------------------B----------------------------------------------------v
-----------------------------------------------------------------------?-------------------------------------------------------------------------------------------------------------------------------f
-----------------------------------------------------------------------------------------------------------------????--------?-------------------------------------------------------------------------f
-------------?--------------------------------------------------o--------------------------------------------------------------------------------------------------------------------------------------f
------------------------------------------T-------------------------------------------------------------B-------------------------------------------------------?--------X-----------------------------f
------------------------------------------|-----?-----------------------------------------------------------------------------------------------------------------------XX-----------------------------f
------------------------------------------|T--------------------------------------------------------------------------------------B------------------------------------XXX-----------------------------f
m--------------E----------------X---------||-------------------E---------------------E------------------------------E-----E------------------------------------E---E--XXXX---------E------------------EX
XXXX------XXXXXXX--XXXXXXXXXXXXXXXXXXXXXXX||XXXXXXXX-------XXXXXXXXXXXXXXXXXXXXXXXXXXXXXXXXXXXXXXXXXXXXXXXXXX-------XXXXXXXXXXX------XXXXXXXXXXXXXXXXXXXXXXXoXXXX----XXXXXXX------XXXXXXXXXXXXXXXXXXXXXX
