----------------------o-------o------o----------o-----------------------------------------------------------------------------------------o-------------------------------o---------o-------------------
----------------------------------o------------------------o--o------------------------------o------------------------------------o-------------------------o---------o---------------------------------
-----o--------------------------|----------o----------o--------o-X--------------o-------o---------------------------------------o---------------o-------------------------------------------------------
-----o-------X---o-----------------------------T--o-------o-o----------------------o-------------------------------------T----------------------------------------o-------------------------------------
--------------------------------------o-----------------|----o-X----------------------------------------------------------o----o-------------------------------|---o-----------E------------------------
------------------------o-------------o------------o----------------oB--o----B-----o--|------X-------------T-----------------------?--------------------------------ooo-T-------------------------------
---------------------o----o----------o--o---------T--------------------------o------------------------|---------------o----------o----o--------------o------------------o--X------o----------o------o---
---T-----------------------T----o-----o-------------------X-----------------------o--------------o------o----X----B---------------?-----------------------T-----oo-------------------------------------v
------------------------o-----------E-------o------------------------X---o--X------------------------o------------------------------------------------------------------------------o---------o--------f
-----------------o------o---------------------------------o---o-----------------------------------------------------------|--o---------B-------o-----------------------o-------------------------------f
--M-?---?BMM--?MMX---?o--X-M--oM-BB-----XMMXX---X--MM--?-------XM---BB-B--B---B?B--M-X?M--?-MM-M--Bo-??----??-XXXM-MB?-X---MM---oB--XXoB?--?M----BBX-?-----X?-X----?--M----X-B--?B------------?--?-XX--f
--------M-|?--------XB-??-XB---M?MBB-oX-XMX------?--B--M--?-B----X-X??MBX-X-M?o?B-B-?M-B-B-?MX-XB-X-M-MM--?B--X?------oBX?B--?M---?---???-|-?--B-X-o--?-BX--XM?M-B--X---B---X-Xo-BBB--M-MMB-M--Bo--X-?Xf
-B-?---X-TT-TTT-TT--MM-M-T--M-TT--T?-M-?-XX-TT-?XB??TT--TXX-----T-XM----o-XT-MX-X--BT-TTX--MT--B--X-T?T-T--TMTTT--TX-M----TMTT?B--TMBToTT-M-?M-T-TTM-BT-BMXT?-XT-TX-T-MBT-oMBMM--TTTTT?-TT-TTT?-X-T----f
-BXB?T-TT|?B|||-X|?-oM-?MT-TX-|T--|?---|X-|-||TT-MTT?|?X|TMTo?T?|BT|?oTBT-BT-T|---TT|?||T-B-|-|M-T-||TX-|-T-B|T---|---?M?T|-BT--B-B--XTMTM?-M?-BB|||B?TTBT||M--To?BM|XMM|-oT-T-M-T|||T--|?X|X-BTT?TTT--f
m-ET-E-||EEM||TBMMEETEETE|-|EB?|TE|TE-TX?T|E|M||E||X||EM||-|M-EBBB|ETB|-|-ETM|ETEET||TTE|?MTMT?BE|-E||Eo|-EBTE||BE|EEo---||EB|EEEE|TM||MXETE|TXEEE|EoE||-T|BTTE|B|EX|?E||M-|MEEBB|T||TTBE?E|||T|?E|||ETX
XXX|X|X||||||||X|||||XX|||X|XX||||||XX|||||X||||X|||||X|||X||X|||X|||X|X|XX|||||XX|||||||XX||||X||X||||X|X|||||||X|XXXXXX||X|||X|X||X||||||X||X|||||X|||X|||||||||||||||||X|X|XXX||||||X||X||||||X|||X|X
