-------------------------------------o------------o------o----o--------o----------------o---------------------------------------------------------------------------------------------------------------
-------------------------o-----------------------------------------------------------------o-------------------------------ooo----------------------------------------------o---------------------------
----------------------------------------------------------------------------------------------------------------------------o--------------o------------------------------------o-----------------------
------------------------------------------------------------------------------o---------------------------------o------------T------o---------------------------o----o-----------------E-----o----------
----------T---------------------------------------------|------------------------------M-----------------E------------------------------o----------------------------------------T------------o----o----
--------------------------?-------------------------E-----------------------------------------------------------------------o-----------|-------------------------------------o-------------------------
-----B------------------------B----o------------o---------------|-----B-------------X---------------|-------------------------------E---------T---------------------o-------------T--------------o--o---
------------------------------------------------------M-------------------|--?---------o---------------------------------------------------o--------------------------------------------o--o--o--------v
---------o-----------------------------------------o----------o------------------------o-----o-------------X-----------|-------------------------o-----------------------------------------------------f
-------------------------------------------o--|------------|----------------------------------------------------------------------------------------------------------------------o--------------------f
---?--M-MBX----------M?-----M-|B-----o-----?X--X?X-M-------?--M----?-------Xo--?-M?---M-B--ME------B--B----?-----X------?----X?B-----X--B--Boo-M--?-BB----X---B-??M-XXXM--M--?---o---M?XMM?-----B-MB?--f
-?-B--------?------o----------?-------B-----X-XB-BB---XM?X-?--M---o-?--o------?M--?-M----X------BM-----Bo------M---B-----?X-XXX--M------??--o---------MMX-X-?--?M?-MM-M---M----T---M----B---?MM--X--MM-f
--T-T--B?BTTT|-----?--T-T-TTMX--B---TTTT?-X--TT-------o--BMTTT?-----T-?T?--oB---XMT-BB-?-BX---?-T-TT-M-TBT----T?----?oT?X?-TT--T-B--M--MT-T--T--M----BT?T-XXM-TXoX-T-B?T?-X-TTTM-Xo---T?-XTBTMBTBTTB-X-f
--TXB--X-||||---?T---X|-|o||T-TT--TX||M|--X--X|T?|--TT-BT?-|||T-----|--|-BX---X--MX-oT--TTT-BT--|-T|TBX|-|M---|?TX--BT----B||T-|------T-TT|-?|--M---?|T||B--X?TX?-X|-?-|TTBX|||TB-B--BT?TT|M||o|-|X-XT-f
m-M-EETTMT||XTX-E|-M-?|E|X||E-|MEET-XEE|-oET?|-?|--T||?T|-M|oE|T--T-T?-|-B|E-ETT-M|-T|--|||B-|B-|B|||--|-|--M-|-|B-T---EXE-|||-|-MEE-B|-|EE-E|MEB-T--||||-X?--|E?BETXBETM|E|Mo-|X-TEEo|E|ET-BEETEE|MTTEX
XX|X|X||X|||||XXX|XXXX|X|X|||X|||||X||||XXX|X||||XX|||X||XX|||||XX|X|XX|X|||X|||XX|X||XX|||XX|XX|X|||XX|X|XXXX|X|XX|X|XXXXX|||X|XXXXXX|X|||XX|XXXX|XX||||XXXXX|XXXX|XX||||||||||XX|XX||||||X||X|X|||||XX
