------------------------------------------------------------------------------------------------------------------------?-------------------------------------------------------------------------------
----------------------------?-----------------------------------------------------------?----------------------------------------------------------B----------------------------------------------------
-----------------------------------------------------------------------?--------------------------------------------------------------------------------------------------------------------------------
-----------------------------------------------------------------------------------------------------------------------------------------------------------------------------------------------???------
--------------------------------------------------------------------------------------------------------------------------------------------------------------------------------------------------------
----------------------------X-----------------------------------o---------------------------------------------------------------------------------------------------------------------------------------
---------------------------XX---------------------------------------------------------------------------------------------------------------------------------------------------------------------------
--------?-----------------XXX---------------------------------------------------------------------------?--------------------X-------------------------------------------------------------------------v
-------------------------XXXX------------------------------------------------------------------------------XXXXXX-----------XX-------------------------------------------------------------------------f
------------------------XXXXX---------------------------X------------------------------------------------------------------XXX------------------X------------------------------------------------------f
-----------------------XXXXXX----BBBBB---------------------------------X--------------------------------------------------XXXX-----------------XX----------------------X-------------------------------f
----------------------XXXXXXX--------------------------------------------------------------????????--------------XXXXXXX-XXXXX----------------XXX---------------------XX-------------------------------f
---------------------XXXXXXXX------------------------------------------------------------------?------------------------XXXXXX---------------XXXX--------------------XXX-------------------------------f
--------------------XXXXXXXXX-----------------------------------------------------------------------------o------------XXXXXXX--------------XXXXX-------------------XXXX-------------------------------f
m----------E-------XXXXXXXXXX-------------------------------------------X------------------------------?--------------XXXXXXXX-------------XXXXXX------------------XXXXX----E--------------------------X
XXXXXXXXXXXXXXXXXXXXXXXXXXXXXXXXX----XXXXXXXXXXXXXXXXXXXXXX-------XXXXXXXXXXXXXXXXXXXXXXXXXXXXXXXXXXXXXXXXXXXXXXXXXX-XXXXXXXXXXXXXXXXXXXXXXXXXXXXXXXXXXXXXXXXXXXXXXXXXXXXXXXXXXXXXXXXXXXXXXXXXXXXXXXXXXX
