----o------------------------------------------o---------------------------o-----------------------------o--------------------------------------------------------o-----o-------------------------------
-------o---o---------------------------------o------o-o---------o--------------------------------------------o-----------------------------o-------o-------------o------------------o-----------o-------
------------o------------------------o-----------------o-o-------------------------------------o--------------------------------------------------------|-------------o------o--------------------------
---o------------------------------------------o-------o------------------------------o------------------------------------------------------------------o-----------------o----------------o--T---------
--------------------o-----------------o-----------o------X----M----?--------------oo-------------------oB---------------------------o-------------o------o-----------o-----------------o----E-----o-----
----?o--------------------|----------------?-----------------o---------------T---------M------------------------------------------o------------------------------o-----o-o--o-------o--------------o----
--------o-------------o----------------------o---o-------------X-----|-------------------------------------------?------------o-----------|---|-------------|-o-----------------------------------------
--o---|-------------B----------------?------------------------------o------B------------o----o--o----------------------X--------E-------------o-o----------o-------------------------------------------v
-------------------------------o--------o-------------------------------------------------?----------------o-----------M-----o-----M------------------------------------o------------------------------f
----o--------M----T-----------------o------------------------------o------------------------o---------------------------------------------o------o---------------------o---------o--o------------------f
-------X-XoM?X-----MXM-?X--?M--------X-?---BM?MB?-oM-?------M--M-BXX--XoM---M---o-------X--XBBM--MX----B-M--B-B-M-o-B-XX-B--XM------B?M-o--BXMM--oB?BM-X-oB--o--X---X-----XMM--?o-?B--MBM?-?XX--BM-??B-f
------o----XX-X?---MXBMXMoBB-MM----BB--?B--B-M---M-?----M---M-----MX--??M-----B-B--M-----X--Bo----B-------XXMB-B-MM--M??MB-M-BM-M---B--M?-M--XXo--XBMX-?-?-?---MXM--XM--o--------X--M-B--M-M-?---BBX---f
-TTX-B-BX-To-TXT-T?T-TTT-----BX?-Bo--oT-??T-B-BM-|TMT-TBT---T--X?TB-X-T-TT--TTMX?T--TMXTB--BXT?BXTTTM-M---XB?-BT--TXTTBTM--X-o-?MB-XX-XT--TBT---T--XT----T-B-TT-TMT-?XB?XT-oB---T-?---T--X--MMo--TTB-X-f
-||-MXTT-M|-TM-|T|-|T||T---XT--|?X|??-|-TXT?B-||?-B-|-o?|--T|T-?T|-TXT-M|X--M?T|-|TTMT-||--BTT---||X-?TTT--T?TTTBTM--|T|-XM-?-TX-BXTM-M|X?T--o-M|-TBTM-TT|-To||Mo||?---B-MTB-XT-|-M-|-|M-M?TT|BT-X|MT|-f
m||TE||BE-EM|T?E||EEE|||o?oBMXT|-EEEEEET|oM---?EEE|E|T|ETTT|||TEEEBTETEX|MTB|E|MEE|E?|T||-oXTTTTEE|TT?|?TEE|ET||E|E||T||o|XXX|?|T|-|EBX|?EE-|?E||TET||EB|EE|EEEX|E?M-EXBETToTE?B|XTT|XEEEEB|||E|B|E|||TX
X|||||||XX||||X|||X|||||XX|X|X||X|||XX|||X|XXX||XX|X||||||||||||||X||||X|||X||||X||||||||XXX||||X||||X|||XX|X|||X|||||||||X|X|||||X||XX|XX|X|XX|||||||||||X|X||X||||X|XXX||||X|X|X|||X||XX||||X|X||||||X
