-------------------------------------------------------------------------------o------------------------------------------------------------------------------------------------------------------------
---------------------------------------------XB---------------------------------------------------------------------------------------------------------------------M-----------------------------------
--------------------------------------------------------------------------------------------------------------------------------------------------------------------------------------------------------
-----------------------B-----------------------------o---------------------------------------------------------------------------------------X--------------------------?-------------------------------
--------------X---------------------------------------------------------------------------------------------------------------------------------------------------------X-------------------------------
--------------------------------------------------------------------------------------------------------------------------------------------------------------------------------------------------------
-------o------------------------------------------------------------------------------------------------------------B-----------------------------------------------------------------------------------
-------------------------------------------------------------------------XXXXXX------------------------------------------------------------------------------------------------------------------------v
---------------?---------------------------------------------------------------------------------X------------B-----------------------------------------------------------------------o----------------f
---------------------------------------------------------------------------------------------------------------------------------------------------------------X----------------------X----------------f
----------------------------------------------------------------------------------------XXXXX------M---------------------------?------------------------------------B--X-------------------------------f
--------------------------------------------------------------------------------------------------------X---------X---------------------------------------------------XX-----------------XX------------f
------------------------------------------------------------------T-----------------------------------------------XX-------------------------------------------------XXX-------------------------------f
----------X--o-----------------------------------------------B----|-X---------------------------------------------XXX-----------------------------------------------XXXX---------------------------BBBBf
m---E-E---XX-----------------------B---------------------------E--|-XX----E--------------------E------------------XXXX---------------------------------------------XXXXX-----E-------------------------X
XXXXX-o-B-XXXXXXX-XXXXXXXXXXXXXX----XXXXXXXXXXXXXXXXXXXXXXXXXXXXXX|XXXXXXXXXXXXXXXXXXXXXXXXXXXXXXXXXXXXXXXXXXXXXX-XXXXXXXXXXXXXXXMXXXXXXXXXXXXXXXXXXXXXXXXXXX-----XXXXXXXXXXXXXXX---XXXXXXXXXXXXXXXXXXXX
