---------o---------------------o--------------o-----------------------------------------o------------------------o-----o----------------------------------------------o----------o----------------------
-----------------------------------------------o-------------------o---------------o-----o---------o-------------------------------------------------------------o-----o-----o--o--------------o--------
----------------o----|-------------------o----o--------------------------o--------------------------------------------------------------------------------------o---------------------------o-----------
-------------------------------------------o----------------------------------o----E--------------------------------------------------------o---------o--------------------o--------------------------o-
------------------------------------------M-o------------?------o-----------------------------o-------------------------------T------o-------------o-----------|-----o----------------------------------
------o---------------------?---M--o--|-----------------------B----------------o-----o-------X-------------T------o--o------o---------------------------------------o---T-------------------------------
----o----o------?----------------------------------------B---------------------------o--o-------------|--------------------B---------B-o-----X-----------------o-----------X---o------B-----------------
--------------o-------------------------------o----o--------------------oo-----X------oo--------o--------------X---------------o--------T-----------------T--------------------------------------------v
---------------------------------|--------------T---------------------------o------------------------------o---o-------------------------------oo----o-------------------------------------------------f
-----B---------------------o--------------------------o----------------------o-------------------oo------------o------o----T-o-------------------------o------------------------o----X-----------------f
----o--?-X--?M--MMBB-X-Mo?M-MX----B---M--XX-M-X------?------M-??X--X--B------B--?MXMB---?X--?-?o-?--?BBB---M--BXX---BBBXX?----?-B--?X---M--XB-XM-XB------XM-----XM----?Xo-B-XXBXB?-B---o--M?---MXX-B--Mf
-BX----M?B-----?XX-MX-BB?M---M-XB---M-XX--o-?-M--o--M-?-----XM--BM?-B--o------B--B?-?--B-B-???X-BMB--B?M--M---B-X---o-??X-XXM-----------M?--B--X------?--M----?B----M--B-X---XXXM---X--------oXX-M---B?f
--MX?-X-?XTT??--B-?--X-TT-M-o--B--X-MMT-o?-TTT--?B---TTT-TT-MoTM---MX--M---M-TTXTTT?T-BMTXo---TMMM?EXX--TT-T?TTTT?-?--BXX---T--M---MTT-T-?--oT--?-B-TXT-TM-MT?TBT-BTT?T-?BT?o--XTMTT--TXTT-TBMBB--MXoTXf
-TB|XTXBT-||TTT-TT-o-?TT|-TT-TT|TM-T|M|-T-??||TTBBT-M|T|TT|Xo-|?B---X-T|?-o--T|T|||BX?|TMT|-TTB----oX|B-T|-|-?||B|To-M--B--XTXBT-TMT||-||----T?TXX|-TTB-TM-?|o|B|TX|TT|?|M|TT?-|XT|TTT|?||TT?|---TB?-|-f
mXTEX|TEoXTT|||?||EEMTT|-T|TMT|||?-E|E|-|-TE||||ETEBT|||M||B?E?|EEE?BX||EE-ET|||EE|XTE|E|ETEo||X-T-ET|BM||T|-|E|EEETEXEBM-MTT-EE-|E|M|?||-BMT|E|ET|ET||T|TEM|ET|||?T|||-E?||EMTME|||TETE||TXT|BETEXEo|-X
X|||X||||X||||||||XXX|||||||||||||X||||X|X||||||X||X||||||||X||||XX|XX||XXXX|||||||X|X|||||||||XX|X||||X||||X|||||||X|XXXX|||XX|X|||||X||XXX||X||||X||||||XX|X||||X||||||||||X||||||||||||||||XX||||X|XX
