-------o----------------------o------------------------------------------------------o----------------o-----------o--------o-----------o----------------------------------------------------------------
------------------------------o-o-----------------------------------------------------------------------------------------------------------------------------------------------------------------------
--------------------------------------------------o-o-------E-----------------oo-------------ooBo-o------o------------o---------o-------------------o-X-o--------o-----------------------o--------------
------------------o-------------------------------------------------------o-----o--------------------------o--------B---------------------o-------------o-------------------------------o---------------
----------T-o----------o--------------o---------------------------------------------------o------------------------------o-B---|-----------------------o------------------------------------------------
--------------------T-----o-----------------|--------------o--o-----------------|-------o-------------o-----------------------------------------------B-----------o-------------------------------------
---o--------------T--------T------------------------------B------------o-----o------------o--------T-------E--o--------B------o----o---o----------------------o--------------------------------------o--
----------------------o--------o-----------------------------------------?--------------------------o------------o---------------------o--o------------------B---o------o--B---o-----------------------v
--o-------------o-------------------------------o-------------o-----------o-----------------------------------------o----------------------o-----------------------------------------------------------f
-o---------------o-----------o-----o----------o---------------------------o--------o--------o-----o-----------------------------------------------------------------o-------------------o-----o--------f
--X-?-M-?B-X-M--B-XM?-MX-MMBBBM--XB-B?---?--E?---------?BX?----X?--M-X-BMX-X??M----B?--B--M-XM--X-X-X----M-?M---?M---MM---?-BM--oX-M---M-----?BM--o-B---BX--M-XB--B-?B-?-M-MB-MoB--XEo-?o-B--?---------f
-M??----XB-M--?B-----MB--M?---M--?--B-|---?B-------X-M--X---BB-M--B-X--MXXX------o--?B-------X-o---M?-X-M--B--B?o--X--o-------M-BoBB--?-----?-X--o-B----?B-M--?X----M----X-X---?---BMX-BX-B----B-B?----f
-XT---Bo?-MTM?M??X---T-TTT---M-TB-?-?T-TBXB-B-BTX?---XXBTTM-T-?--?T-T--TM--X---TT-TT-?---MMB?-oMXT-TBTT---TM-MMTXM?---TBMM--?-X--MT-TM---M-B--B?--o--?-TT----T---T--?XToBTToTToT-MT-MT-T--T-?---?MBTT?-f
--|---M--?Too|?-X|B--MTT||MTTTo|B-BMT|B|-MTBM--|BB-X---T|MX-|TMTTBTo?-o|---T-?-||-||oTT?-------BT|XB?||-M-|TT-TXTT|--XT-|---X---MMTTTT-oXTTMTTXBT-TMBMT||MT-T|BTT|X-?T|TT||oB||TT-?X-|-|--?oT--TT?T|T|?f
m||TBXXET-EEB|-TE?|EEE|||B|ET|T|BTTEM|||oEB-?--||ETEEE-ETTT-TTEE|-|-|-E|B-EETEE||?||-|||E-TTEMX-X|TE-EEBE-?|ETTET|ETX|EE|B-TEMTTTM|T||XET|MTXE-TT-B--BT||EBXMT?|||EETE|B|E|-T||T|X|T-|-|Eo--T?M|||||MTEX
X|||XX|X|X||||X||||X|||||||||||||||X||||XX|X|XX||X|XXXX||||X||X||X|X|X||XXX||XX||X||X||||X||XXXX||||X|||XX||||||||||X||X|XX||X||||||||X|||||||X||X|XX||||X|X||X|||XX|||||||X|||||X||X|X||||X||X|||||||XX
