---------o---------------o---------o-----------------------------------------------------o---------------------------------------------------------oo-----------------------o------------------o---o----
-------------------------o-o-----------------------------------o------------------------o--o-------------------oo-o-------------------------------------------------------------------------------------
-------o-------------------------o--o----o----o---------------------------------------------------------------------o-o--------------------o-o------------------oo--------------------------------------
------------o-----------o------------------o-------------------E-------------o------o-------------o-----oo----------B-------------------o-----------o-----------------------o---o----o------------------
------o--------------------------------o----------------------o----?-------------------M---o------------------------o------o-------------------------------------------------o--------------------------
--------------------------?o---o-----------------o-------------o?o--------o-------------------------o----------------------o---------------------------M----------o------------o---|-------o------------
------------B------o----------B-------------------------o----o-------|---o-----o----X---------------|----?-------------B------?----------------B--------------o-----------------------------o-----------
------------o--------------o-----------------------------------------------------------o-----------------------------------------------------o-----|---------B---o------o--B---------------------------v
-----------------------------------o------------------o----?--B----------------------------------------o---------?------------------------o---------o-----o-----------------------X--------------------f
----------o---------------------------------------------o--------------o--------------------o-------------------------o----------o----------------o------------------------o--------------o-o-------o--f
--M-XM---BMM?--M-X-X--?-B-BX--|B-ooMX-M--?-?--BM?XBB--X---X--X-----XB-?-?--M???B-B-----MMM--E-?-X-??-MB--??-?----X------B?-M-?------E---??---B--XB??-?X-?---M-XB--B-?B-?--B?--B-----B---M-M-o-??M-----?f
--X--B--M-BM?-X--?M-?B-X---?-X-X--M?--B?-XX-?B-X---?-----oo---oX?--MM---X----X-M--M---MB-XX-?----X----?B-?-o-??B?---M-X--B---?--B---M-?-X?-B-B--MMBMMB---o-X--?X-?--B------o--BM-M--M-B?-------B---X-X-f
-X---?-TMTT--XMM??--M----T-BM--TTX?-T-B-X-B---T?--MM--MB---B-TTB-?---T-T--MXTX---TX-?B-TBXTT-T--T-T--T-TTT-?XT?X----XT?-TX--T?-TooBTTT-ToBTB-B-TT--T-T---T---T---T--?-?oTT-BXTX---B-TTX-BXXX-MTTXT-TT?Tf
-BB--|-|-|?TTBT|?--TTMB?T|--XTX||?TT|TXMTTMTXT|X--?-X?o-XTX-M|?-BT?--|M|T-TB||TT-|--o--|T?||?M?-|T?TX|TT|T?-T|o-X-TB||B-||T?||MTXBX|B|X|X-TB---||T?|-|TB-o|TT|BT-|XB?TXT||?|||?BX-BT||T-T?T---T|XT-T?-|f
m|TEEEXET||XBE|ETT?||TET||-XT|M|EE||||TT||TE-|||-??TETEE?E|BE|E-T|ETTTE||E|T|||EE|E-EX-BET||TTX?T||EET|||BTM|||TTM|--|?MEE|-|EM|?TE||oE||T|-TT-EXTE|T||MB|TXMT?|E|EETE-B||BMEE|--XM||||E|o?X?X||EME|TE|X
X||XX|X||||||X||||X||||||||X||X|||||||||||||X|||XXX|X||X|||X|||X||X|||X||X||||||X|XXXXX|||||||XX|||||||||||X|||||X|X|||X|||X||X|X|X|||X||||X||X|||X|||||X|||||X|||XX||X||||||||XXXX||||X|||X|X||X|X||||X
