-----------------------------o--------------------------------------------------------------------------------------------------------------------------------------------------------------------------
-------------------------------------------------------------------o------------------------------------------------------------------------------------------------------------------------------------
----------o----------------------------------------|-------------------------------------------------------------------------------B--------------------------------------------------------------------
---------------------------------------------o-----------o-----------------------------------------X------------o-----o-o----------------o-----------------------------------------o--------------------
---------------------------------------------------------?---------------------------------------?------B------------------------------X-----E-----------------|---------------E------------------------
----------o---T-o---------------------------------------------B-----------------------------------o------------------------------------------------------------o----o---T-------------------------------
-o------o--------------o----------------o----T-----------B------o------------------------------|-------------------------------------B-------------------------------------X----------------------------
----o-----?------o---------------------------------------------------------------------------------------o------------------------------------------------T-------------------o------------------------v
----------------------------------------o-----------------------------------o--------------------------------------------o-----------------------------------------------------------------------o-----f
------------------E-------------------------------oT------------------------------------?-------------------------------X----------------------------------------------o------------o----o-------------f
----XB--?------------------------------B-----M-X-o----------X----B---o-M-----B----MX-BB----?--M-X--X----?-M|--------?---M--oM--------o----X---?-----------o-X--B---------------XBM---------o--MB--X----f
-MXMB--X--X----o----XM----B-?----?M-X-----M-----?----------------?-X------B----------X-----------B-MB-B-M-----M?-|-M-ME--M---------?-B--------?-?--M---------------------------------?----?------------f
--M---T--X----B----X-------?-XB------?B--To----MT-TX--X---T--X------X------------X--X----?------X-----T?------T--M-XX--TB---B--------T--------X-T----T-M--X?---?--T---------T--?-------T---T-X-X-------f
---M--|----TM----T--T?TT------?-----B---M|---?--|-|----TT-|TT?------X-----o-----------------------MT--|-TT----|------B-|-o-T---??----|-------T--|---B|-----|---M--|--T---B--|-TM---T---|MX-T--XT----T--f
m--E--|---ETEEEB-M--M|||?TT--E|-ET---?T-BE??-T-EEo|----E|-||T-Bo----TX-MET-ET--M--ETEX-B-T----E-E--|E-|E|E----|-T---T--|X--|E-TBM--?-|-----EE|--|----|--E?E|TTT|--|--|-TTTT-|E|---E|---|TE-B---|M--M|B-X
XXXXXX|XXXX||XXXX|XX||||X||XXX|X||XXXX|XX|X|X|XX|X|XXXX||X|||XX|XXXX|XX|X|XX|XXXXXX|XXXXX|XXXXXXXXX|XX|X||XXXX|X|XXX|XX|XXX|XX|XXXXXX|XXXXXXX|XX|XXXX|XXXXX|||||XX|XX|X||||X|X|XXXX|XXX||XX|XXX|XXXX||XX
