---------o-----o-------------------------------------------------o-------o--------------o---o---o----------------------o---------------------------------------------o----o------o----------------------
-------------------------------------------------------------------o---------------------o-------------------------------------------o-------o------------------------o---------o--------------o--------
---------------------|-------------------o-----o----o--o-------o--------------------------------------o-------------------------------------------------------------------------------------o-----------
-------------------------------------------o--o-------------------------------o----E----------o-------o--------------------------------------o----------------------------------------------o---------o-
---------------------o---------------o---oM-o----------------------------------------------o----------------o------------o-----------------------------------------o-o----------------------------------
------o---------------------?---M-----|------------------------------------------------------X-------------T-------o--------------------Boo--------------------o----ooo-T-------------------------------
---------o------?-o--o-------------------------------------o----o-------------------------------------|-o--------------------------------------o------------------------o--X---o------B-----------------
----------------------------------------------o-------------------------o------X----------------o--------------X--o----------X--------------T-------------T-----o------o-------------------------------v
---------------------------------|--------------T---------------------------o-------------o----------------------------------------------X-------------------------------------------------------------f
-----B----------------------------o-----------------------------------------------------------------------------------------------------M---------------------------------------o----X-----------------f
--B-??---M--M---BMB-----X-M-M?B---MB--M--MB---X----M--B?--------?BB--oX?--BB-B--?XBM-MM-B-B-M--o?--X-MXB--B---M-X?X--MMBMBX----oM------X----?X?-----?---B?o-X--B---X-MB---?X---XB?-B---o---?---MXX-B--Mf
--?--B-o?M------Mo-??X?BB-M-M---B---B-X??-BB---?-o-oM--B?--------?-X-Xo--?M---BX-X----B---M?XXXMM-B--BBM-X-BB-------B-?-M--MoXX--X-----M--M---?-?--o-o---------B-B-----------BMXM-B-X--------oXX-M---B?f
-MTTMX?TM-T-??--B-?--MT?TTM-T---M-TTTB-T----T---?B-M-M-T?T-T-?TT--MXXX-T-B-o-TMTTo----TTT-T--X-MBTMEToo-T-BMBTM-T---X-B-TXM-To-TT-BTMT-TT-?--?TBT----T-M-TX?--T?-T---TM-T-T-BMMXTMTT-XTXTT-TBMBB--MToT-f
--||?-?|T-TX-|T-M-TT-|||||-T|?TXTT|||--|BTo-|B-T--TM-M-|||-|TMX|-TT-XM?|--TT-|-|-TT-T?||?M|TTTBB-|TX||TB|?XB-?-|?TT??MT-|M-?|TT|-XT|-|T?|-XM-M|-|---BB---|T|X-?MX|T--?MM|-|----|XT|TTT|?||TT?X---TB?-o-f
m-||E?T|?o|BX||ETM|XE||TT|-E|o|-|E||TT-XE|-BE--|oETT--E?E|TE?EE|?||XTE-|BT||T?-||TE?|-||EEEo|MBET||E|E|M|EEEET-|E|TXETTT|MEX||ETE-||E|||MT?--?|-ME-X-TEM-|?TXE|EE|TB?EE||EEB?EEBEM||TETE|||ET|BXTEXEX|-X
XX||XX|||X||X||||X||X|||||X||X|X||||||X|X|XX|XX|XX||XXX||||||||||||X|XX|X|||||X||||X|X|||||||||||||||||X|XXX||X||||XX|||||XX|||||X||X|||||XXXX|X||XXX|XXX|||||||||||X||||X|XX|X|||||||||||||||XX||||X|XX
