-------------------------------------------------------------------------------?------------------------------------------------------------------------------------------------------------------------
--------------------------------------B--------------------------------------X------------------------------------------------------------------------------------???????-------------------------------
---------------------------------------------------------------------------------M----------------------------------------------------------------------------------------------------------------------
---------------------------------------------------------------------o------------------------------------------------------------------------------------------B---------------------------------------
--------------------------------------------------------------------------------------------------X-----------------------------------------------------------------------------------------------------
----------------------------------------o---------------------------------------------------------------------?---------------------------o-------------------------------------------------------------
---------------------------------------------------------o-X-------?------X----------------------X------------------------------------------------------------------------------------------------------
------------------------????------------------------------XX-----?-------XX--o----XXXXX-----------------------------------------------------------B-----B----------------------------------------------v
---------------------------------------------------------XXX------------XXX----------------------------------------------------------------------------------------------------------------------------f
--------------------------------------------------------XXXX-----------XXXX----------------------------?-----------------------------------------------------------------------------------------------f
-------------------------------------------------------XXXXX----------XXXXX-------T--------------------------------------------------------------------------------------------------------------------f
------------------------------------------------------XXXXXX---------XXXXXX?------|-M----------------X-------------------------------T-----??????------------------------------------------------------f
-----------------------------------------------------XXXXXXX--------XXXXXXX----M--|-----------------XX------------------------------X|-----------------------------------------------------------------f
----------------------------------------------------XXTXXXXX-------XXXXXXXX-------|--X-------------XXX------------------------------X|-----------------------------------------------------------------f
m---------------------------------o---------------oXXX|XXXXX-X----XXXXXXXXX-------|-XX--E---------XXXXE------E----------------------X|X-----------------------------------------E-o-------------E------X
XXXXXXXXXXXX----XXXXXXXXXXXXXXXXXXXX-------XXXXXXXXXXX|XXXXXXXXXXXXXXXXXXXXXXX----|XXXXXXXXXXXXXXXXXXXXXXXXXXXXXXXXXXXXXXXXXXXXX----X|XXXXXX----XXXXXXXXXXXXXXXXXXXXXXXXXXXXXXXXXXXXXXXXXXXXXXXXXXXXXXXX
