-----------------------------------o------------o-----------------------------------------------------------------------------------------o----o---------------------------------o--o-------------------
---o--------------------------------------------------o------------o----------------o--------o-o--o----------------------------------------------------------------------o-------------------------o----
-------o-------------------o----------------o---------------------o-----------------------------------------------o---------------------------o---------------------------o-----------------------------
-----o--------o--------o-------o---------o-----T---------o-------------------------o---------------o---------o-----------T---o--------------------------------------------------------------------------
-o-------------------------------------------------------?------------------o----------X----------------------------------o-------o---------------o-----------o|---------------o------------------------
----------------------------------o---o--------o--------------B------------------------------X-------------T-----------------------?----------------------------------o-------T------o-------------o----
------------o-o?----------o---o-B---o---|---------T------B------o--------------o----------------------|---------o-----------o----o------o----------------------o-----o--?--------------------o----------
---------------------------------------------o-----------------------------------oo--------------------------X----B---oo----------?-------------------------o------------------------------------------v
--------o---------o--------o----o-----o-----o-------------o-----------------o--------------------------------------o----------------o--------------------------------------o-o--o--X-------------------f
-------------o----oo-----o-------------------------------o------------o-----------oo------o-o-----------------------------|---------o--B---------------o-----------------------o-------------------o---f
-M--B?--?MB----?-M---MoB-X--B?---?--MB--?-TXX---?----o------M--M-B---oMM?--?BB--B------XM-X-?--?--X--?M-?M--oBBX--X--X-B---?M--X-M-??---BX-o--?--X?-BM-?-B--?---MM-------B------M-M----?M-XB--?-B?----Mf
-M---XM-B?-----oMMo--?X--B-??-XMX-----X--MXX--B--X----X?-M-BXM-X-???--?--XB?------XBBXX?-X??XX-MB-X-X--B----?--?-?----Mo?-B--M-?--XM--???-BXB?-M---B--XMBMM?--?B--B-?---X-------M--BM--M----------B-X-Mf
-T-BT-TTX-T-XT?M-XTX-TTTT--BoT------?BTBB-T-MB--X-?TT----MT--M----MTX--M----o-T--XBBT--o--TTT-?B-MTM--X-TMMX?ToT?---TMM---TM-X?M-TM?XBoMT----?---?MTTX-T-T---???--TM-X-?-??T-XXB-T--TT-BBXTM-MXM-M-T---f
-|-|TB||B?|BM|-M--|T-|TT|-?T-|--?--X-B||TM|?-|BXB--|?B?TTM|TTB-----?X-----o---|-T-B-|--MX--||M?M-T||XBTBT-TX-TXT--M-|-TMM-|M-Xo--Xo--BT-|T-T-BMTo--o|T-?XMT?To?-?-|T----TBTB?--X-MT?M|-oT-|BM-T?-MT|?-Tf
mEEE|E|XEo|ETETTB-|ETX|||MM|E|E-|EEEB-E-E||E-ETT?T-|E|E|T||?MEEEXBE|TXEXET-ETTTM|---|E-TTTT|?|EEM|T|M||||BB-B|E|MTTB?EX-E-|TTEXXE|ETXEE-||M|MEEEM-M|||EMEEXEEM?BE-|--T-T|||EEEMBE||E||M-|E|TT|M?-E|o?E|X
X|XX|X|||X|X|||||X||||||||X|||XX|XX||X|||||XX|||X|X|||X||||||XX|XXX||X||X|XX|||X|XXX|XX|||||||XXX|||X||||X||X||||||X|X|XXX|||||X||X|X||X||||XX|||XX|||X|X||X|XX|XX||X|X||||||X||X||X||XX|X||||||XX||XX|X
