-----------------------------------o------------o-----------------------------------------------------------------oo----------------------o---------------------------o---------o-------o---------------
-----------------------------------------------------------o---o-o-------------o-------------------------------o-------------------------------------------------------o--------------------------------
---------------------------o-----o---o---o----------------------o---------------o-------------o---------------------------o-XX-----B-----------------------------------o--------------------------------
-----------o-----------o-------o---o-----o-----T-----------------------------------o------o---------------------------o---------------------o------------------------------o----------------------------
-M-------o---------------------------------------------o|------------------o--------------------------------------------------------o--X-----E-----------------|-------o--------------------------------
--------------T-------------------o---o--------o-------------------o---------B----------------o------------T----------o---------------------------------------------o---T--------------------o-----o----
-----------------o------o-o---o-B-------|---------T--------------------------o-----------------|------|--------------------o-o-------B-------------o-----------o-----------X----oo----------------------
----------?----o-----------------------------o------------X--------o----o---------o----------------------o-----X---------oo-------------------o---------o-T--------o---------------------o-------------v
--------------o--------------------------o--o------------------T------------X------------o----o-----o------------o--------|-----------o------o-------o-----o------------------|------------------o-----f
------------------E------------o------------------------------------oo------o-----------?----o-----------------------------------------------------------o----------------------o--oo----o-------------f
-X?B?|??----M--?-----M-M-X-B--B--X-------?TXX---?----X------B--BXBMX-oX?---BMBB?---M-?BoX-BX--MX?-X------?-BX-M-??M--X--------B?---X-----MX-?-B-o--BM-?o-XB------M------M-Xo---B?---M------oBMMB--X----f
-o------M-M?B-??oB-???X--B--X-XXX---M-X--MB---M--X-B--XMB-?X---X----?---?----Mo?-----X-BB-X----?-MB--?-X--?--M--XXX-------M----B--B?-B----o---X??--X-?oM-Mo-?-?B-M?-M---BBM-B-M-B?-B-X-XM??-M--M------Bf
--TB-T-T----TMB-XTBMTTT?----oT----B-?T-X--TT-T--B---?-T-TTT--?B--XT-X-BT-----MBT-M-M--BM-?-TT---X-o?-MM-TXTT?T--M?-T-XT-M-T-TTTX--TB-MXM-T----X-MTT?-To?TX-?TT-?---oTXT-TXB?TT---MMT-T-TTMX?-XTT-B---T-f
-oT?T|T|T-?T|B-TM|?M||T|-T??-|--T-MT-|B|TX||-TB-B--BTTTo-T|TBTT-B?|BX-?|-T?T-BT|-T--M--o---||-?---|?TMT-|X||-|?-|TTT--|M?T|XT||B|o|-XT---|Mo-MBT-M|X-|-T|M-?||T-X-XTT-|T|?X||ToMB-X|B|T-||?T-M||T-TMT|Tf
mM|EE|EB|TM|XTM|?|TT|T|EB|-|T|X-E-E?XTEXEME|-|BTMT-T|B|EE|||TEE|T?|-BXBEE|-|TMB|B|T-T?B|TET||ET?EE|-XEEE||||B|oETB||-EEEBM|M|||XT-|E-|-XMEEET-E|-||--TE||TTMT||ET?E||TETB|EM||EE?-T|T||M||E|EM|||-?TM|TX
X||X||||||||||||||||||||X|X|||XX|XX|||||||||X|||X|X||||||||||||||||XXXX|X|X||X||X||X|XX||||||X|XXX|||||X||||X|XX||||X||XX||X|||X|X|XX|X|X||X|XX|X||XX||||||X|||||XX|||||||||||XXXX||||||||X|XX|||X|||||X
