-------o-----o---------------------------------------oo-------------------------------------o---o----------------------o---------------------------------------------o----o-----------------------o-----
----------------------------------------------o-----------o--------------------------------------------------------------------------o-------o------------------------o---------------------------------
----------o------------------------------------------------------------T------------------------------o-------------------------------------------------------------------------------------------------
----------------------------------o----------------------o--o---E-----------------------o-----o-------o--------------------------------------o--------------------------------------------o-----------o-
--------------------------------o-------o----------------------------------------o---------o----------------o------------o-----------------------------------------o-o---------E-------------B----------
--------o-o---T-----o------------------E----------------X--------oo-----o---oB--------|------X-------------T-------oo-------------------B-o--------------------o----ooo-T-------------------------------
-------oo-------------------------------o---?-----T--------------------------o------------------------|-o--------------------------------------o------------------------o--X---------------o-----o------
----------?-------------------------------------------?-----------------------------o----o------o--------------X--o----------X--------------T-------------T-----o------o------------E------------------v
-----------------------o---------B------------------------------------------X-----------o-o----------------------------------------------X--------------------------------------------------------o----f
------------------E----------X-----------------------------o----------------------------------------------------------------------------M---------------------------------------o----|-----------------f
-B-XM|M-?--?-----M-MMX-B-----M-?-?-B--B--XB--------?-X---?-M-X--E?-------X-----X-?---X--MX?-M--o??-X?MXB--B---M-XMX--MMBMBX----oM------X----?X?-----?---B-o-oo-B---X-MB----X----XB?X-?-X?B-X-?----?o--Xf
-M-X---?---B--?-X---B---X-?BB--?-MMXX-M?---?M---X--??-M--M?--?-M--?X--BM--B?---X?--?BBB---M?XXXMM-B--B-M-X--B-------B-?-M--MoXX--X-----M--M---?-?--o-o---------B-B-----------BMo-BB--X---?-M-?--?-?-X-Bf
--T-MToT--T-TXT---BTo?T?oMoTT-B---MXT----TT---X-M-TTM-T?M??oT?-M-XTBT--XT-XMT----TB-?X?TT-T-MX-MB-MBMoo-T-BXTTMTT---XMB-MXM-BT-TT-??MT-TT-?--?TBT----T-M-TX?--T--T---TM-T-TTBMMX-TT--BT?TM-MTM-B-TXo-T-f
-?|TT|?T?-|MB-TTT-??-M|T--|||XT--TTX|X-TT||X?MBT-TB||-|-MT-T?-BX--XT|-T-|MTMXTTTTT--T-|T?M|TTTBB-?TX||TB|?XBM?-|?TT??MT-|M--|TT|-XTM-|T||-XT-M|T|---BB---|T|X-?M?|T--?MM|-||---M-TXTT-|T|X--|XT-M|-|TT-f
mEM|||EE|-||TE|?MET|BT||EEE||-EEMT|MM-X|E||X-TX|E|E|E?|TT?E|TEEX-T|||BTE|-?-EB|||EME|TToTEEo|MBETE|E|E|E|EEE|T-|E|T-EE|T|MEX||||E-|-E|T|MT?|-?||EE-T-TEM-|BTXE|EE|TB??E||TE|MEEEB|?M|TBE|MEB|-B-T|B|T|EX
XX|||||||X|||X|||X||X|||XX|||X|XX||X|XX||||X||X|X||||X||||X||XXXX||||X|X|X|X||||||XX|||||X|||||||X|||||X|XXX||X||||XX|||||XX|||||X|XX|||||X|XX||||X|X|XXX|||||||||||X|||||||X|XXX||||||||XX||X|X||||||XX
