--------------------------------------------------------------------------------------------------------------------------------------------------------------------------------------------------------
--------------------------------------------------------------------------------------------------------------------------------------------------------------------------------------------------------
------------------------------------B-----------------------------------------------B---------------------------------------XBBBBBBB------X-------------------------------------------------------------
-------------------------------------------------------X---------------------------------------------------------------------------------------B--------------------------------------------------------
--------------------------------------------------------------------------------------------X-----------------------------------------------------------------------------------------------------------
-----------------------------------------------------------------------------------------------------XXXX--------------------------------------------------------------------------o--------------------
----------------------------------------------------------XXX------------------------------------------------------------------------------------------------------XXX--BBB-----------------------------
------B-------------------------------------------------------------------------------------------------?------B---------------------------------------------------------------------------------------v
----------------------------------------------------------------------------------------------------------------------------------------------------------------------M--------------------------------f
---X-X------------------------------------------------------------------------------------------------------X---------------------------o--------------------------------------------------------------f
-----XX----------------------------------------------------------------------------------------------------------------------------o--------------------o--------------X----------------T--------------f
-----XXX---------------------------------------------------------------------------------------------------------XXXXXXX----------------------------------------------XX----------------|--------------f
-----XXXX--------------------------------------------------------------------------------------------------------------------------o---------------------------------XXX----------------|--------------f
-----XXXXX-----------------------------------------------------------------------------------------------------------------------------X---o------------------------XXXXT--------------T|--------------f
m----XXXXXX----------------X-------------E--------------------------------------------------------------------------------------------EXX------------E--E----------XXXXX|---E-o------E-||--------------X
XX---XXXXXXX---------XXXXXXXXXXXXXXXXXXXXXXXXXXXXXXXXXXXXXXXXXXXXXXXXXXXXXXXXXXXXXXXXXXXXXXXXXXXXXXXX--------XXXXXXXXXXXXXXXXXXXXXXXXXXXXXXXXX-------XXXXXXXXXXXXXXXXXXX|XXXXXXXXXXXXXX||XXXXXXXXXXXXXXX
