--------------------------------------------------------------------------------------------------M--------------------------------------------------------------------------------o--------------------
--------------------------------------------------------------------------------------------------------------------------------------------------------------------------------------------------------
--------------------------------------------------------------------------------------------------------------------------------------------------------------------------------------------------------
--------------------------------------------------------------------------------------------------------------------------------------------------------------------------------------------------------
------------------------------------------------------------------------------------o---X---------------------------------------------------------------------------------------------------------------
--------------------------------------------------------------------------------------------------------------------------------------------------------------------------------------------------------
----------------------------------------------------------XXX--------------------------------------------------------------------------------------------------------------?----------------------------
--------------------------------------------------------------------------------------------------------------------------------------------------------------------------------------------------o----v
-------------------------------------------------------------------------------------------------------------------------------------------------------------------------------------------------------f
-----X--------------------------------------------------------------------------------B------------------------------------------------------------------------------------???????---------------------f
-----XX-----o----------------------------------------------------------------o-------------------------------------------------------------------------------------------------------------------------f
-----XXX----------------------------------------------------------------------------------------------------------------------------------------------------------------------------------------------Tf
-----XXXX------------------------------------------------------------------------------------------------------X-----------------------------------------------------------T--------------------------|f
-----XXXXX-----------------------------------------------------------------------------------------------------------------------------------------------------------------|---------------T----------|f
m----XXXXXX-------------------------------------------------------------------------------------------------------------------------------------------------------------E--|-----------X---|----------|X
XX---XXXXXXXXXXXXXXXXXXXXX?XXXXXXXXXXXXXXXXXXXXXXXXXXXXXXXXXXXXXXXXXXXXXXX------XXXXXXXXXXXXXXXXXXXXXXXXXXXXXXXXXXXXXXXXXXXXXXX--------XXXXXXXXXXXXXXXXXXXXXXXXXXXXXXXXXXXX|XXXXXXXXXXXXXXX|XX----XXXX|X
