--------------------------------------------------------------------------------------------------------------------------------------------------------------------------------------------------------
------------------------------------------------------------X------------------------------------------------------------------------------------------------B------------------------------------------
--o---------------------------------------------------------------------------B-------------------------------------------------------------------------------------------------------------------------
----------------------------------------------------------------------------------------------------------------X---------------------------------------------------------------------------------------
----------------------------------------------------------------------------------------------------------------------------X---------------------------------------------------------------------------
---------------------------------------------------------------------------------------------------------------------------XX---------------------------------------------------------------------------
------------------------------------?-----------------------------------------------------------------------------------M-XXX------------------------------------------B--------------------------------
------------------------????---------------------------------------------------------------------------------------------XXXX---------------------B----------------------------------------------------v
---------------------X-----------------------------------------------------------------------------------?--------------XXXXX------------------------------------T-------------------------------------f
-----------------------------------------------------------------------------------------------------------------------XXXXXX----------------------------------X-|-------------------------------------f
--------------------------------------------------------------------------X-------------------------------------------XXXXXXX---BBBBBB------------------------XX-|-------------------------------------f
---------------B-------------T-----------------?-------------------------XX------------------------------------------XXXXXXXX--------------------------------XXX-|-------------------------------------f
-----------------------------|-o----------------?-------T---------------XXX-----------------------------------------XXXXXXXXX-------------------------------XXXX-|-------------------------------------f
-----------------------------|--------------------------|--------------XXXX----------------------------------------XXXXXXXXXX------------------------------XXXXX-|-------------------------------------f
m-----------------------?----|--------------------------|-------------XXXXX---------------------------------------XXXXXXXXXXX-----------------------------XXXXXX-|----------E--------------------------X
XXXXXXXXXXXXXXXXXXXXXXXXXXXXX|XXXXXXXXXXX------XXXXXXXXX|XXXXXXX-----XXXXXXXXXXXXXXXXXXXXXXXXXXXXXXXXXXXXXXXXXXXXXXXXXXXXXXXXXXX-----XXXXXXXXXXXXXXXXXXXXXXXXXXXX|XXXXXXXXXXXXXXXXXXXXXXXXXXXXXXXXXXXXXX
