-------------------------------------o------------o------o----o--------o----------------o--------------------------------------------------------------------------------------------o------------------
-------------------------o----------------o------------------------------------------------o-------------------------------ooo-----------------------------------o------------------------o-------------
----------------------------------------------------------------------------------------------------------------------------o--------------o---------------------------o--------------------------o-----
----------------------------------------------------------------------------------------------------------------o------------T------o--------------------------------------o---o----o-------------------
----------T----------------------------o----------------|------------------------------M-----------------E------------------------------o---------------------------------------------------------------
--------------------------?-------------------------E-----------------------------------------------------------------------o-----------|--------------M---------------------o--------------------------
-----B------------------------B----o------------o---------------|-----B-------------X---------------|-------------------------------E---------T---------------------------------------------------------
------------------------------------------------------M-------------------|--?---------o--------------------------------o------------------o-----------------------------------------------------------v
---------o-----------------------------------------o----------o------------------------o-----o-------------X-----------|-------------------------o--------o---------------o--------------o-------------f
-------------------------------------------o--|------------|----------------------------------------------------------o---------------------------------------------------------oo----------o-------o--f
---?--M-MBX-------M--M?-------|B-----o------X--X?X-M-------?--MB---?-------Xo--?-M?---M-B--?E------B--B----X-----X?-----?----??B--B--X--B--Boo-M--?-B?----MB---B?MB-MMM--oB---B---?oXo---?---B?-?-ooM--f
-?----------B---M-o-----------?-------B-----X--B-B----XM?X-?--M---o-?---------?MoM?-M----X------BM-----Bo------?---B------X-XX---M------??--o--------B--M----MM-B---B----X--M--M?--o--BM--MBo--Mo---B-Xf
--T-T--B?BTMT|-----B--T-T-TTMX--B---TTTT?-X--TX-------o--B-TT-?----BT-MTB--oB---XMT-MB-?-BX---?-T-T--M-TB-----T?----?oT?-?-TT--T-B--M--MT-T--T--------M-T?--TT-MTX?M---TB---?TT?TT?--TT-TTXT--TT?TTXXBBf
--TXB--X-||-|---?T---X|-|o||T-TT--TX||M|-----X|?T|--TT-T-?-T|?T-----|--|-BX---X---X-oT--TTT-BM-o|-TMTBX|-XM--M|?TX--BT--M-B||T-|------T-TT|-?|-XM----T-BMoTT|?-?|-|T--T|BXT-MTMT?|---TX-||--TT||X|T?-BMf
m-M-EETTM||?XTX-E|-M-?|ETX||E-|METT-|EE|EoET?|-E|--T||?TE-M|TE|T--T-T?-E-B|E-XTT-E|-M|--|||BE-B-|B|EB--|-EX---|-|B-TE--EX--|M|-|-MEE-B|-|EE-E|XE--T--|ET||EX||-||EE|-E|T--|E-|EX|To-X|EEE|M|||TEE||EB|MX
XX|X|X||X|||||XXX|XXXX|X|X|||X|||||X||||XXX|X||||XX|||X|XXX||X||XX|X|XX|X|||X|||XX|X||XX|||XXXXX|X|X|XX|XXXXXX|X|XX|X|XXXXX|||X|XXXXXX|X|||XX|XXXX|XX|X|||||||X|||||XX||XX||X||||||XX||X||X|||||||||X|XX
