-------------------------------------------------------------------------------------------------------?------------------------------------------------------------------------------------------------
--o-----------------------------------------------------------------------------------------------------------------------------------------------------------------------------------------------------
--------------------------------------------------------------------------------------------------------------------------------------------------------------------------------------------------------
-----B-----------------------------------------M------------------------------M----------B------------XXXXXX-----------------------------------B--------------------------------------------------------
------------------------------------------------------------B-------------------------------------------------------------------------------------------------------------------------------------------
--------------------------------------------------------------------------------------------------------------------------------------------------------------------------------------------------------
------------X-----------------------------------------------------------------------------------------------------------------------------------------------------------BBB------------X----------------
-----------XX----B------------------------------oB--------------------------------------------------B---------------------------------------------------------------------------------XX---------------v
----------XXX---------------------------------------------------------------------------------------------------------------------------------------------BBBB-----------------------XXX---------------f
---------XXXX---------------------------------------?-------------------------------------------------------------------------------------------------------------------------------XXXX---------------f
--------XXXXX----------------------------------------------------------------------------------M-----------------------------------------------------------------------------------XXXXX---------------f
-------XXXXXX---------------------------B---------o-------------------------------------------------------------------------------------------------------------------------------XXXXXX---------------f
------XXXXXXX--T----------------------------------------?????------------------------------?---?-------------------X-------------------------------------------------------------XXXXXXX---------------f
-----XXXXXXXX--|--------------------------------------------T-------------------------------------------------------------------------------------------------------------------XXXXXXXX---------------f
m-M-XXXXXXXXX--|------E-------------------------------------|--------X------E-------------E-------------E----------------------------------------------------------------------XXXXXXXXX---------------X
XXXXXXXXXXXXXXX|XXXXXXXXXXXXXXXXXXXXXXXXXXXXXXXXXXXXXXX----X|XXXXXXXXXXXXXXXXXXoXXXXXXXXXXXXXXXXXXX----XXXXXXXXXXXXXXXXXXXXXXXXXXXXXXXXXXXXXXXXXXXXXXXXXXXXXXXXXXXXXXXXXXXXXXXXXXXXXXXXXXXXXXXXXXXXXXXXX
