--o--------------------------------------o--o--o----------------------------------------------------------------------o---------o---------------------------------o-------------------------------------
-------------------------------------------o--------------------------------------o----------------------------------------------------------------o-------------o---------------------------o--o-------
------------------------o---------------o-----M----------------------------------o-------------B-o------------o--o--------------------------------------|-------------o---------------------------------
----o-----o-----------------------------------o-------------------o--------------------o-----------X----o-----------------------------------o-----------o-----------------o----------------o--T-------o-
-------o-----------------------------o------o-----------------M----------o-----o------------o-------------------------------o-----o---------------o------o-o---------o-----------------o----E-----------
-----------|----o---B----------o------o------------------B--------------o-X--------------o-------------------oo----o-----------------------o---------------------------o-o--o-------o--------------o----
--o--------------------|-------------------X-o--o----M-------o-X-----------------------------------------?--------o-----?-----------------|---|---------o---|-o-----------------------------------------
------o------------------o-----o---------------------------o-------o-----------B-------------------o-------------------------------o----------o-o----------o-------------------------------------------v
--------o---------------B---------o--------o-----------M---------o--------------------------o------------------o--------------------------------------------------------o------------------------------f
-----o-----------o--------------------------------------------------------------------------o-------|-----------o-E---------------o-------o----------------------------o---------o--o------------------f
-MM--B--B---??-----o----o-X?X-MB-M?XBB-?Xo--X?X-?B--?--XX-M?--B--B--M--X?--X-----B?-?X----?----?-oX-?-?--???MM--BX-B?M------MX-o-----BX----MXMM--oB?MM-X-oB--oX?----X------MM-MBo-?X--MBM--?XX--BM--MB-f
--X-|B--MX--o?-?-?----------B---?MMB--o----M---XM-M---?--?o?X?------X--MX-B--o-X-?M-?--?B--X---MB---?---------M??-oBMX--B----BMB---XXX--?-M--X-M--oBMX-B---?---M-B--XB--o--B---X-o--B-B------B----BM---f
-T----BM---B--TMX-T---T-----TTXTX--B-BXT-T--TXTo-T-MM-oMTB-B-MBX?T?-MT-X-XBT-MX--Xo-TT--XM?-o-T-Xo?--XTXTT--TX-T-TTB----X-T--T?--B---?TX--T-T---T--XM--T-T-ooT--TMT-?-??XT-o----X-?-X-T--X--TTo--TMBXX-f
-B--TBX-??-TXT|T-?T--XT?----TTXMTTM-o?-|-|?-|-|-T|TM|o-T|-X--BT-T||--|?T---T-|--TTTB?|M----M--|--|B-oX|T|T?X|B-BM|?T-TTMTT|T-T|-M?T-X?|TX?|--MMT|Xo-|TT|T??Xo|XM|||oT-B?-|TBTXTBMTM-B-|M-M?X|B-T-?TM||Bf
m|MTEEEMEEMTT|-|TE|EBXTTTT-TETEE||ME|EE|EE|T|?E?|BBBTEEB|?EET?|B|BXTXMT|ETM|EEEEE||T|T|?EX-|-?TEB|E-EETXTBEE||-TM|XEETEEM|||EETT|M|--B?B?EX-E?E||EoTET||EE?|E|BX||BM|E-BTBoo|E?B?|TT|-EEE-EM||TTX||E||TX
X|||||XXX|X|||||||||XX||||X|||||||X|||X|X||||X|X|||X||X||X|X|X||||||X|||X|X|X||||||||||XXXX|XX|XX||XXX||||XX||X|||||||||||||X||||X|XX|||XX|X|XX||X||||||||X|X|XX||||||XX|||||X|XX||||X||XX|X||||X||||||X
