-------------------------------------o------------o------o----o--------o----------------o--------------------------------------------------------------------------------------------o------------------
-------------------------------------------------------------------------------------------o-------------------------------ooo-----------------------------------o------------------------o-------------
----------------------------------------------------------------------------------------------------------------------------o--------------o---------------------------o------------------------o-oo----
----------------------------------------------------------------------------------------------------------------o------------T------o--------------------------------------o---o----o-------------------
----------T---------------------------------------------|------------------------------M-----------------E------------------------------o---------------------------------------------------------o-----
--------------------------?-------------------------E-----------------------------------------------------------------------o--------o--|--------------M---------------------o--------------o-----------
-----B------------------------B----o------------o---------------|-----B--------o----X---------------|-------------------------------E---------T---------------------------------------------------------
------------------------------------------------------M-------------------|--?---------o---------------------------------------------------o-----------------------------------------------------------v
---------o-----------------------------------------o----------o------------------------o-----o-------------X-----------|-------------------------o--------o---------------o--------------o-------------f
-------------------------------------------o--|------------|--------------------------------------------------------------------------------------------------------------------oo---------------------f
-?-?--M-MBX----------MX-------|B-----o------X--X?X-M-------?--M----?-------Xo--?-M?---M-B--ME------Bo-B----X-----X------?----??B-----X--B--Boo-M--?-B?-----B---BBMB-MMMM-oX---B---?oXo---?-M--X--X-?--?f
-?----------?-----------------?-------B-----X-XB-B----XM?X-?--?---o-?---------?M--?-M----X------BM-----Bo------M---B------XBXX---M------??--o--------B--M----MM-B---B----X--M--M?--B--BM--M-?-o-MX-o---f
--T-M--B?BTMT|--T--B--T-T-TTMX--B---TTTT?-X--TT-------o--B-?T-?-----T-?TB--oB---XMT-BB-?-BX---?-T-T--M-TB-----T?-B--?oT?-?-?T--T-B--M--MT-T--T--------M-T?--TTMMTX?M---TB---?TT?T-?--TT-TXX--MXX-XT???Bf
--TXB--X-||-|---|T---X|-|o||T-TTT-TX||X|-----X|TT|--TT-T-?-||?T-----|--|-BX---X---X-oT--TTT-BM--|-TMTBX|-XM---|?T?--BT----B||T-|------T-TT|-?|--M----T-BMoTT|?-||-|B--T|BXT-MTMT?T---TT-TT-TX-T?-||--?Bf
m-M--ETTM||?XTX-||-M-?|E|T||E-|M|E|-EEE|-oET?|-?|--T||?TE-M|TE|T--T-T?-E-B|E-ETB-B|-T|--|||E--B-|B|E|-B|-M----|-|B-T---EX--|M|-|-MEE-B|-|ET-E|XEB-T--|ETTTEX||-||EXM-E|T-E|E-|EX||o-B|EE||E|TT|EE|||?EEX
XX|X|X||X|||||XX||XXXX|X|||||X|||||X||||XXX|X||||XX|||X|XXX||X||XX|X|XX|X|||X|||XX|X||XX|||XXXXX|X|X|XX|XXXXXX|X|XX|X|XXXXX|||X|XXXXXX|X|||XX|XXXX|XX|X|||||||X||||XXX||XX||X||||||XX||X||X|||||X|||X|XX
