------------------------------------------------------------------------------------------------------------------------------------XXXXX---------------------------------------------------------------
------------------------------------------------------------------------------------------????----------------------------------------------------------------------------------------------------------
--------------------------------------------------------------------------------------------------------------------------------------------------------------------------------------------------------
--------B--------------------------------------------------------------------------------B---------------------------------------------------X-B---------------o----------------------------------------
--------------------------------------------------------------------------?-----------------------------------------------------------------------------------------------------------------------------
-----------------------------------------------------------------------------------------------------XXXX-------------------------------------BBBBB-----------------------------------------------------
----------------------------------------------------------------------------------------X---------------------------------------------------------------------------------------------------------------
-------------------------------------------------B-------------------------------------XX--------------------------------------------------------------------------------------------------------------v
-------------------------------------------X------------------------------------------XXX--------------------------------------------------------------------------------------------------------------f
-----X-------------------------------------------------------------------------------XXXX-----------------------------------------------o--------------------------------------------------------------f
-----XX-----------------------------------------------------------------------------XXXXX---------------------------------------------------------------o-----------B----------------------------------f
-----XXX--------------------------------B------------------------------------------XXXXXX----------------BBBBBBBBB-------------------------------------------------------------------------------------f
-----XXXX------T------------------------------------------------------------------XXXXXXX--------------------------------------------------------------------------------------------------------------f
-----XXXXX-----|-------------------------------------------------B---------------XXXXXXXX----------------XXXXXXX-----------------------X---------------------X-----------------------------------------f
m----XXXXXX----|----------------------------------------------------------------XXXXXXXXX----------------------------------------------XX-------------E-----------------------o---------------B---E----X
XX---XXXXXXXXXX|XXXXXXXXXXXXXXXXXXXXXXXXXXXXXXXXXXXXXXXXXXXXXXXXXXXXXXXXXXXXXXXXXXXXXXXXXXXXXXXXXXXXX--------XXXXXXXXXXXXXXXXXXXXXXXXX-XXXXXXXXXXXX----XXXXXXXXXXXXXXXXXXXXXXXXXXXXXXXXXXXXXXXXXXXXXXXXX
