------------------------o-o-------------o----------------------------------------------o---o--------------------------------------o-o-o--o----------------------o----o----------------------------------
-------------------------o---------------------------------------------------------o-------------------------o------------------o--------------------------o--------------------------------------------
------------------------------------------------o---------o---------------------------o---o---o------------?----o-----------o---------?---------------o--------------o----------o-----------------------
------------------------------------o-------o-----------------------------------------------------------------------------------------------------------|-----------------oo-----------E-----o----------
----------T-------o------------o-------------------------------------------------o-----o---------------------------------------------------------------X---------o---------------T------------o---------
------------------o-------?---------o--------o--------|-------------o-o--o----------------------------------------------------------------------------------o---o----oo---------------------------------
----oB---------o--------------B-o-------o-------------------X---------B-------------X---------------|-----------------X-----o------o----------------------------------------------T--------------o--o---
---------------------------------------------B-------------------------o--|--?--o------o----------------------------------o----------------------o--o----------T--M---------------------o-----o--------v
-----------------------------------o----------------------------o----------------------------o---------oo------------o---------------------------------B------------------o----------------------------f
--------------------------------------------------------------------------o----------------------o-----------o--------o---------------------------o-------------------------------o------------------o-f
-XX?-----XX---?-X-?---?---BM-B|B----B--?B--BB-------M??MM-BX-M?XXXB-XBX--?--?B?--M-XB---MMoBE---X-XBB-M--M------------XXB-B---B?--o-B------M----M---MoB-X-o--M-?-B--M-?----B-?---oB--M?XMM?-----B-MB?--f
-M-MM??---o-XB----B-X?--X-oM?----?---------?-?-?B---?-?-?--o--?--------o-X-M-?B-MM?B--o--B?-oMMB--?Mo--X-MX--B-B-MXB?--o-----o--XXX-------BX-o-?-?MM--?--MB--?-?---B-X--?---M--T--XM----Bo--?MM--X--MMBf
-MTTXT--TBXXT|o--BT--M--X--BM---?M-X--TTTBB--?TXXoTT--T-T--?BT-X?T-T-TXX----?-T-?XT-??T--?--M--BM?TBT-TTTM?TT-M-T-TTTT-T----B-T---?---BoTTM-TMTToT--M-B---X-M-XTTX--TMMMX-T-TTTM-Xo---T?-XTBTMBTBTTB-X-f
--B|BBB-oMTM|M---T|TBT--X?B--?XBMMT|-BT||TB-M-|T?-||--TT|?---MTTB|?|-|-M-ToT--|T-M|-T-|--To-TMM-B-|TTT|T|-T||?o-MM|||MT|MTX?-B|--XTTB?-T||?-|-T|?TTX?BT--M---MT||TT||B?TX-MM|||TB-B--BT?TT|M||o|-||-XT-f
mEBTEEET|T|BTE-EEoEEM|EEE-|E--?XTXE|ET||||TXE||TX-T?EE|T|EETX|T?-|EEE|ETEB||M-||-EX-|EMTEBE-|EoTTE||||||ET|||MT?ME|ET|||E|T-oT|TE?||MEEE|BEE|-|ME||T|EEEMTTETo||||T||BXEET|X||-|X-TEEE|E|ET-BEETEE|TTTEX
X||||||||||X||XXX|||||X|XX|XXX||||||X||||||X||||XX||XX||||||X|||X|X|X|X|X|||X|||X||X|X||X|XX|XX||X|||||||||||||X|||||||||||X|||||||||XX||||X|X||X||||||XX||X|||||||||||||||X||||XX|XX||||||X||X|X|||||XX
