--------------------------------------------------o------o----o--------o----------------o-------------------------------------------------------------o---------------------o---------------------------
---o--------------------o--o---------------------------------------------------------------o-o-----------------------------ooo-------------------------o----o-------------------------o-----------------
---------------------o----------o-------------------------------------------------------------------------------------------o----------o---o------------o---------------------------------------------o-
------------o--------------M-o----------------------------------------------------------------------------------o------------T------o---------------------------------------o---o-------------------o---
------o--------------o----------------------------------|------------------------------M-----------------E------------------------------o---------------------o-B------------o--------------------------
------------------------o---------------------------E-----------------------------------------------------------------------o-----------|------------o-----------------------------|--------------------
------------B----------------------o------------o---------------|-----B-------------X---------------|-------------------------------E---------T---------------------------------o-----------------------
----------------o---------------------------------o---M-------------------|--?---------o---------------------------------------------------o-------------------------------B---------------------------v
---------------------o-----------------------------o----------o------------------------o-----o-------------X-----------|----------------------------------------------------------X--------------------f
--------------------------------oo---------o--|------------|----------------------------------------------------------------------------------------------------------E----o--------------------------of
--X-XM--o------?-?X-M?-?M--MoX---M----------X---?X-M-------?--M----?-------Xo--?-M?---M-B--ME------B--B---MX------------?----??B-----B--BX-Boo-M-XX-BB------??B-?--?X---------------M-----B-X-?--M---XXf
----XM----X---?-B-M-B--?X-X-X--??-----B-----X-XB-B----XM?X-?-?BB--o-?---------?M--??-----X-B-----------Bo------M----------X------M------??--o-------B-----X-----o-------B--o--M--M--M---B-B--o---------f
----T-XXMTT--B-XXTTT-M-T?MM--X--T----TTT?-X--TT-------o--BTTT-?-o---T-?TB--oB---MMT-BM-?-MX-----T-T--M--B------?----?oT?-?-TT----B--M--MT-T--T-------T-?XTT---?T-T-B-----B-TTTX---X-M-XT-------T--o--TXf
-?|BM-M-T||TTXMT-|||-B?TX-T?o-TT|TTXM|M|--M?-XTTT|T--T-T-?|||?T-----|--|-BX---X---X-oT--T-T-BM--|-TMTBX?-XM---??-X--BT-----||T----Xo--T-TT|T?|--M----|--TBTM-B-|T|---?----T|||T-E-MT--MBT----TB|----B|-f
mM|-EETE||T||-M|-||EBM|TEET?E-||EBTTEEE|-oET?||TT-|TE|ETE-||EE|T--T-T?-|--|E-ETT--|-T|--|-EB----TBTE|--E-E------EB-E--?EX--|MT---BEE-B|-|EE|E|XEB-T--EB-T||EX--T||-XT-EET-?||B|--EM|B-|||-?X-TE|EETE---X
X||X|X|X|||||XX|X|||X||||||X|X||||||X|||XXX|X||||X||X|X|XX|||X||XX|X|XX|XX||X|||XX|X||XX|X|XXXXX|X|X|XXXXXXXXXXX|XXXX|XXXXX|||XXXXXXXX|X||||X|XXXX|XX||X||||XXX|||XX|XXX|X|||||XXXX|XX|||XXXX|X|X||XX|XX
