-----------------------?---------------------------------------------------------------------------X-------------------------------------M--------------------------------------------------------------
--------------------------------------------------------------------------------------------------------------------------------------------------------------------------------------------------------
-----------------------------------------------------------------------------------------------------------------------------------M--------------------------------------------------------------------
----------------------------------------------------------------------------------------------------------------X---------------------------------------------------------------------------------------
----------------------------B-----------------------------------------------------------------------------------------------X---------------------------------------------------------------------------
---------------------------------------------------------------------X-----------------------------------------------------XX-----------------------------------------------XXXXX-----------------------
---------------------------X----------------------------------------XX----------------------------------------------------XXX---------------------------------------------------------------------------
----------------------------------X---------M----------------------XXX---------------------------------------------------XXXX--------------------------------------------------------------------------v
---------------------------------XX-------------------------------XXXX--------------------------------------------------XXXXX--------------------------------------------------------------------------f
--------------------------------XXX------------------------------XXXXX-------------------------?-----------------------XXXXXX--------------------------------------------------------------------------f
---------------------o---------XXXX----X------------------------XXXXXX------------------------------------------------XXXXXXX------------------------------------B-------------------------------------f
-------------------X----------XXXXX----------------------------XXXXXXX---------------------------------------------??XXXXXXXX----------------------------------B----------------?????------------------f
-----------------------------XXXXXX---------------------------XXXXXXXX--------------------------?--T----------------XXXXXXXXX--------BBBBBBBB----------------------------------------------------------f
----------------------------XXXXXXX--------------------------XXXXXXXXX-----------------------------|---------------XXXXXXXXXX-----B--------------------------------------------------------------------f
m---------E----------------XXXXXXXX--E-----------------E----XXXXXXXXXX-----------------------------|--------------XXXXXXXXXXX-----------------------------------E-----------E--------------------------X
XXXXXXXXXXXXXXXXXXXXXX----XXXXXXXXXXXXX----?-XXXXXXX-XXXXXXXXXXXXXXXXXX---XXXXXXXXXXXXXXXXXXXXXXXXX|XXXXXXXXXXXXXXXXXXXXXXXXXXXXXXXXXXXXXXXXXXXXXXXXXXXXXXXXXXXXXXXXXXXXXXXXXXXXXXXXXXXXXXXXXXXXXXXXXXXX
