---------------------------------------o----------------------------------------------------------------------------------------------------------------------------------------------------------------
----------o---------------------------------------------------------------------------------------------------------------------------------------------------------------------------------------------
------------------------------------------------------------------------------------------------------BBBBB---------------------o-----------------------------------------------------------------------
-------------------------------------BBBBBB---------------------------------------------------------------------------------------------------------------------B---------------------------------------
--------------------------------------------------------------------------------------------------X------o----------------------------------------------------------------------------------------------
-----------------------------------------------------B----------------X----------------------XM-------------------------------------------o-------------------------------------------------------------
--------------------------------------------------------------------------X-----------------XX---X------------------------------------------------------------------------------------------------------
---------------------------------------B---o-----------------------------XX----------------XXX----------------------------------------------------B-----B----------------------------------------------v
------------------------------------------------------------X-----------XXX---------------XXXX---------------------------------------------------------------------------------------------------------f
-----------------------------------------------------------------------XXXX--------------XXXXX---------------------------------------------------------------------------------------------------------f
-----T----------------------------------------------------------------XXXXX-------T-----XXXXXX----M----------------------------------------------------------------------------------------------------f
-----|-------------T-------------------------------------------------XXXXXX-------|----XXXXXXX-------X--B----------??????------------T-----??????------------------------------------------------------f
-----|-------------|------------------------------------------------XXXXXXX-------|---XXXXXXXX------XX------------------------------X|-----------------------------------------------------------------f
-----|-------------|-----------------------------------------------XXXXXXXX-------|--XXXXXXXXX-----XXX------------------------------X|-----------------------------------------------------------------f
m----|------E------|----?E---------------------X------------------XXXXXXXXX-------|-XXXXXXXXXX----XXXX--------------E-----E---------X|X-----------------------------------------E-o-------------E------X
XXXXX|XXXXXXXXXXXXX|XXXXXXXXXXXX------XXXXXXXXXXXXXXXXXX--XXXXXX-XXXXXXXXXXXXXXXXX|XXXXXXXXXXXXXXXXXXX-----XXXXXXXXXXXXXXXXXXXXX----X|XXXXXX----XXXXXXXXXXXXXXXXXXXXXXXXXXXXXXXXXXXXXXXXXXXXXXXXXXXXXXXX
