---------------------------------------------------------------------------------------------------------o------------------------------------------------------------------------------------o---------
-------------------o----------------------------------o------------o----------------o-----o----------------------------------------------------------------o------o-----------------------------------o-
----------o-----------o-o---o------------o------o-----------------o-------------------------------------------------------------o--B---------------------------o-------------------------o-M---o--o-----
---------------------------------------------o-----------o-------------------------o---------------X------------o-----o-----------------------------------o-o------------------------o-oo---------------
----------------------------------o------------|--------------------------o-o-o--------X---------?------B--------------------------o---X-----------------------o----------------------------------------
----------oo-oT--o-o--o--o------M-----|-----------o----------oB-----------------------------------o------------o---------------------o--B--------o--|---------------------------------------------------
-o------o---------------------------------------o--------B------o-------------------------o----|-------------------------E-------o---B-------X----------|----------o--------------------------------oo--
----o----o?----------------------------------------------------------------------oo--------o-------------o-------------------------------------------------------------------------o-------------------v
-----------------o------E--------|------------------------o---o-------------o-------------------------------------------------o----o--o-------------------o---------oX----o--B--------------------o----f
------------------E--------------------------------o--o--o------------------------oo----------------------------------------------------M------------o---------oo------------o-------------|-----------f
--MM-|--?-MX-?-X?--X--B-X-oB-?B--X-M--B--?-B--??-B-Moo---X--M--M-?---oMM?--?MB-------M-XM-M---MXX--X---M?BXMX-------M----???------MB--XB-B--B-M-?---M--XBM--B-B?--?--B?X--B----B?--XM----BXB--B----X-BXf
-X-?BB-X--X-M--o?X--XB-MBXX?B-?BB-?---XX-XX-M--BTM--X-X?---BX--X-?-?-----XB?-------BBXX?--?-BXM--B-MB-BMM-XX--BX-|-MXMB---BXX----?-?---o-X----B?-?M--B--?X-XXB----??----B--o-?---?-XMM-MX--M---X?-----Xf
-TMT--------TT---?T--XXT?TTTBT-?-T-B-TB-o--XBoMBXTX?B--T-MT-?M----M-X--M----o-T--XBB---M---MMT--X-TX-MTMT-----T?XM-TX--XoMT-TB--X?-?XT-To--B-TT-MX-TB-B---T?TXT-TMTT-TTo---T---X--?----TXX-X-B-T-X-BTTTf
-|B|--?T---?T?----|-TB-|M|||T|-XT|MoT|X-TT---X-B-|MT-T?|oM|TTMT---X-M--T--o---o-T-?-|--MX-MTT|-T-?|TM-|-XTT-?BoT---|-?BX---M||-??T-B-?TX-T-o-||-X|-|Mo-MBo|-|T|M|X||-T||--T|-X----X-?-B|TX-?T|?TMM-|||Tf
m|T|TTT|XEET|ETE-E|-|TTEE|EMT|-X-|E-X|T-BE?E-B-MT|EET|EMT||?MM|EEBMETTE|ETEEETEM|---|ETTTEMT|?o|EEE?B-TT|EEBT-|oTE-|T--BB-EM||-E||o-E||EXXT-XT|E|BM|EXXEEB|E|||-|E|?-||EMEE|T-?T-E|EBBME|-ToT|-|M--E||EX
X||||||||XX||||XXX|X||||X|||||X|||XX|||X||||XXXX||X|||X||||||X||XXX|||||X|XX|||X|XXX|X|||XX|||X|XX||XX|||||X|X|||XX||XX||X||||X||||XX|||X||X|||X||X|X||X|||X|||X||||X|||XX|||XX|XX|X|X|||X||||X|XXX||||X
