--------------------------------------------------------------------------------------------------------------------------------------------------------------------?-----------------------------------
--------------------------------------------------------------------------------------------------------------------------------------------------------------------------------------------------------
--------------------------------------------------------------------------------------------------------------------------------------------------------------------------------------------------------
--------------------------------------------------------------------------------------------------------------------------------------------------------------------------------------------------------
--------------------------------------------------------------------------------------------------------------------------------------------------------------------------------------------------------
--------------------------------------------------------------------------------------------------------------------------------------------------------------------------------------------------------
-------------------------------------------------------------------------------------------------------------------------------------------o-------------------------------?----------------------------
--------------------------------------------------------------------------------------------------------------------------------------------------------------------------------------------------o----v
-------------------------------------------------------------------------------------------------------------------------------------------------------------------------------------------------------f
-------------------------------------------------------------------------------------------------------------------------------------------------------------------------------------------------------f
-------------------------------------------------------------------------------------------------------------------------------------------------------------------------------------------------------f
------------------------------------------------------------------------------------------------------------------------------------------------------------------------------------------------------Tf
---------------?--------------------------------------------------------------------------------------------------------------------------------------------------------------------------------------|f
-------------------------------------------------------------------------------------------------------------------------------------------------------------------------------------------T----------|f
m----------------------------------------------------------------------------------------------------------------------E---------------------------------------------------------------X---|----------|X
XXXXXXXXXXXXXXXXXXXXXXXXXXXXXXXXXXXXXXXXXXXXXXXXXXXXXXXXXXXXXXXXXXXXXXXXXXXXXXXXXXXXXXXXXXXXXXXXXXXXXXXXXXXXXXXXXXXXXXXXXXXXXXXXXXXXXXXXXXXXXXXXXXXXXXXXXXXXXXXXX------XXXXXXXXXXXXXXXXXXXX|XX----XXXX|X
