----X--?X--------------o-|--X---XT-T---------M----MB-------------X--?---T-o------E--T--X--?-----M---------o------B-|------------------------B--------------------------?-------------B-o----M-----?-----
----M-T-T---B--X-------M-----o------?------------------------------E--?--X-----|-----E-o--E---------------------T----X---?-------oX-----------T---------------------------------o-----------T-----------
-X--------------------------?---o--M---B-------------------------------M--------o------------o------o-------------------------B---|--E---|------T---|---------X----?--B-----------------o--T--|-------o-
-----Eo-----T--------TE------------------X---o--T-X-----E?---------------|--------------------E-------o-------B---B----------------?---------------------M-T------M------------o-------T--?T-----B-E----
---B-o------o------XB--T---T-------T----?---------T---------|----o----------------?------------E-E--M?--------B----B--M--M-----E---M----------o--X------------M-|-----------------?--M------------------
--------------------M---E------T---------B------|o-------------|o-------?--B----------------E--o-----------?E-E---------|----E----------B------------|--?---------------?XT----------??X?-|-------------
---|o--?T------------?-M---T---o--E-?-------T-------?-------------------------------------------------E-----E---------------EX----?-------X-------M------?----------X-T---o----|-----------E------------
-----o-------------X--T------------------------------|---------BM---|----|------?---M-o--B-------E------M------o--------?-------o-----T---------M-X-------------o---T--------------M---o--E---|B------Xv
------|-----------------M-----?----X----?-------------------T------X-------?--|--T---------------E--o-B--------------o--o------T-------------------------B-----?------------------M-----E-T------------f
-E-------X-------E---------BM-TB---------XE---T------------------M-M-------E-----?-----o----o-XT--------??-B------------------T--B----X-----E---|----B------?-----------------------M------------?-o---f
--B-o--?--------?----T-----------M--------B--o-------------B-----|-----?-M-----------?----E-------|-------------------------o------T-----T-------------------------|--?-M--X-------------?-------------f
------|-------E-----o------------?-M--o|E-T----------T--B---X--T------------X-------o--B---------T------|--------------M----X--------|--------------X--|--------------------------------T-?-T--------M-f
-------o-------------B------------------E--E--------E-|-------------X-------X-----------|-?--B-E--o------X---T--------T---oo--------------X-------------------------------|---o--E-------?-----M-EE----f
---E-|-MX--------X-?--------?---T----------?-----M-------?-X----X------o--------------------?--o-B--T------------------ME--?---T--------?---------M----------------B----------------T----T-----T----X--f
mMM--o--------|---------B----------E---------M----X-?-------B----T----------o----------B--T---------E---------E--------------------oT-T------------------B------------T-------T------T-------B--X------X
XXXXXXXXXXXXXXXXXXXXXXXX-TXXXXXXXooXBXXXXMXXXXXXXXXXXXXXXXXXXXXXXXBXXXXooXXXXXoXXXXXXXMoXXXXXEXX|XXX||XXMXXXXoX|XXXXXXMXXXXXXXXBXXXXXXXXXXXXXXXXX?XXXXXXXXXXXXXXTXXXX|XXBXMXXXXXXXEXXXXXXXXXXXXXXXEXXXXX
