--------------------------------XX----------E---X----------M-------B-X---M------------------o---------------------------M----M--E-----------------X---E---M---------------------------------------------
---------X------E--------M--T------------B-------------?---X-X-------o--E-XM-----?-M--X--------------------E----------X----B--------------------------------o------X------------------------------X--E--
-E---B----X---------oM?---B-o---------------M---------o--------M----M-----?--o-----o-B---E-------------X----?--X-----------------------o--o------------B-?X----------E--------Xo------------------------
-E----?-------?-------------------------B---?----------ME--?---?--E-----E--------------------T------------------B-----X---M---o---B---------------M------M------------M----B----------o--------------?--
----------X-----B----B-------MM---E--X-?---------------o-----------M---o-----BE-----------?------------X---?----o--?----------------B--------oB--?----------------M------------X----B-X--------------M--
--X-----E-M----------M-----------------E----------|-------------------------?---------X---E-----------------Eo--------X--o-----o-----------B-----|B---------------------X--------------X-?-------E------
----M-------------------------o-?----------X-----MB------------oB---o----?-?--|-------------------BMo-----------------?--B---------------B-------M----------B-----------------------------X-M?-------B--
-----------------------?---------?E--|----------------------oM------E-------------X--------oE-----|-B----------E--------------B--?-----M-------------------------|-------------------B-X------M--------v
------------------------------M---X--B----X-------------------BX---B-----------------------------XB-------------------B-----------E-------X---|------------------E--------BE---E-ME-------B----o--?----f
------o----E-----E--------------B-------------------?------------?---?-B-----M---------------------E------M-----X--X--------------------B---?----?--B----------------------E--B-E---------------EX-----f
------------------?---------Mo----T-------X----X----o-------------------------o-------------------------T-o?---------|--------------X------------X--------?-------E----------------M-o----------B-----?f
---X-X--------------------------------B---------------------T-X----------X------X--?------------o-------------------M--B--X-----------------------------o-?----??X-------------X-B-----B---o----------Bf
---T-------------B----------------o-------------------B---?---?----------------------------------X---------X--EM---M-----------o----------------------------|---?-M--M------------------M---X----?--E--f
------------M-----X------XM----------------------?-----------X-------B---?--B-X----o---------------------M--------E?X----B--------------------?--------o----|-------------------M--------M---X--M------f
m-E----------E-X--T----BT--B---------------------------?-------X----E------M--------------------M---|-----------o---M-T----o-----o----------|M------T-X-T---B-M-----M--B----------|-------E--?|--------X
XXXXXXXXXXXXXXXXXXXXXXXXXXXXXXXXXXXXXXXXXXXXXXXXXXXXXXXXXXXXXXXXXXXXXXXXXXXXXXXXXXXXXXXXXXXXXXXXXXXXXXXXXXXXXXXXXXXXXXXXXXXXXXXXXXXXXXXXXXXXXXXXXXXXXXXXXXXXXXXXXXXXXXXXXXXXXXXXXXXXXXXXXXXXXXXXXXXXXXXX
