----------------------------------------------?--------------------------------?------------------------------------------------------------------------------------------------------------------------
-----------------------------o--------B--------------------------------------X------------------------------------------------------------------------------------???????-------------------------------
-------o-----------B-----------o-------------------------------------------------M----------------------------------------------------------------------------------------------------------------------
---------------------------------------------------------------------o------------------------------------------------------------------------------------------B---------------------------------------
--------------------------------------------------------------------------------------------------X-----------------------------------------------------------------------------------------------------
----------------------------------------o----------T----------------------------------------------------------?---------------------------o-------------------------------------------------------------
---------------------------------------------------|-----o---------?------X----------------------X------------------------------------------------------------------------------------------------------
------------------------????----------T------------|----o--------?-------XX--o----XXXXX-----------------------------------------------------------B-----B----------------------------------------------v
--T---T-------------------------------|------------|-------o------------XXX----------------------------------------------------------------------------------------------------------------------------f
--|---|-------------------------------|--------T---|-------------------XXXX----------------------------?-----------------------------------------------------------------------------------------------f
--|---|-------------------------------|--------|---|-----X----X-------XXXXX-------T--------------------------------------------------------------------------------------------------------------------f
--|---|----------------BBBBB--XXXXXXX-|-------B|BBB|B---------XX-----XXXXXX?------|-M----------------X-------------------------------T-----??????------------------------------------------------------f
--|B--|-------------------------------|--------|---|----------XXX---XXXXXXX----M--|-----------------XX------------------------------X|-----------------------------------------------------------------f
--|---|-------------------------------|--------|---|--T-------XXXX-XXXXXXXX-------|--X-------------XXX------------------------------X|-----------------------------------------------------------------f
m-|---|-------o--E---------E------o---|--------|--o|-E|---E-EXXXXXXXXXXXXXX-------|-XX--E---------XXXXE------E----------------------X|X-----------------------------------------E-o-------------E------X
XX|XXX|XXXXXXXXXXXXXXXXXXXXXXXXXXXXX--|----XXXX|XXX|XX|XXXXXXXXXXXXXXXXXXXXXXX----|XXXXXXXXXXXXXXXXXXXXXXXXXXXXXXXXXXXXXXXXXXXXX----X|XXXXXX----XXXXXXXXXXXXXXXXXXXXXXXXXXXXXXXXXXXXXXXXXXXXXXXXXXXXXXXX
