--------------------------o-------------------------------------------------------------o--------------------o---------o-------------------------------------o------------------------------------------
----------------------------------o------------------------------------o--------------------------------------------------------------------------------------------------------------------------------
-------------------------------------------------------------------------------------------------------------|------------------------------------------------------------------o-------------------o---
------------------------M-------------------------------------------------------------------------------E-----------------------X----------o--------B---------------------------------------------------
---------------------------------------------------------------------o-----o-----o----------M-----------------------------------------------------------------------------------------------------------
------------------------------------T-----------M----o------|--------------------------------------------------------|-----o---------o----------?------o----------o------------o------------------------
------------------o---------o------------|----?-----------------------------------------X---------X----------------------?---------------------------------o-------------|--------B---------------------
------------------------------------------o--------------------------------------o----------------------------o----------------------------?o-----o-----------------------o----------------------------v
------------------------------------------------------------o-----------------o------------------------------------------------------------------------------------------------------------------------f
-----------------------------------------------------------------?------------------------------------------------------------------o------------------------B-----------------------------------------f
---------X--------B----------MB?-B------?------B-----X-----M-----M-?---X-o----------------------BB-----?M--MM--?--------X---------------------B--o-X---M----M-o---M--M--------B--M---------X-X-X?------f
------?M--X-?-------X--X----X------------?M---B----X--M-B----BM-----B---------------B----XX---X-----------B--------?-B--------B-----------B------------M---B---M-?------M-----------------------M--M---f
-B------------------?-M------BTT--TTB-T----TT-----X--T----?--?T------o------X----T------o-XT--TT--B-B-B----T---X---TT--------------B---o-----o---------T----?-T----------M----o----X-T--?-T------T----Tf
--?-------T--T-----T-------B--||--|M----T-T||--------|-X--TT-T|--?-B--B--T------T|------|-||-B||--T-----B-B|T-T----||-----?-T-----T------M---M------X--|--B--M|---X--o--------------B|----|X---?T|M---Tf
mE--B-X--T|--|M----|TE-ToTTT-?||-E||--E-|T||?EM--EE-EET-T-|E-||E---EEE--E|E---E-|E------T-||-E||X-|E-E-X---B|-|----||TX----E|X----|M-E--T-?E--TT---E-B-|-E---X|E---?BXT-------EEB---||EE-X|-?T--||---?|X
XXXXXXXXX||XX|XXXXX||XX|||||XX||XX||XXXX|||||XXXXXXXX||X|X||X||XXXXXXXXXX|XXXXXX||XXXXXX|X||XX||XX|XX|XXXXX||X|XXXX|||XXXXX||XXXXX|XXXXX|XXXXX||XXXXXXX|XXXXXX|XXXXXX||XXXXXXXXXXXXX||XXXX|XX|XX||XXXX|X
